It's a beautiful day in the land of Inferna. You jump out of bed excited to compete in this years annual wizard competition. The winner is declared the best wizard in the city. You may be a new wizard, but you're ready to take on the challenge.

You find yourself in your Cabin.

For hints enter "hints".

WizardBattle
An Interactive Fiction by Cameron Haseyama
Release 1 / Serial number 131015 / Inform 7 build 6G60 (I6/v6.32 lib 6/12N) SD

Cabin
A cozy house in the woods. A wooden table is in the center of your room and your bed is in the corner. The Forest is to the North.

On the wooden table is a spell book.

>x house
A small wooden cabin. You have lived here all your life.

>x home
A small wooden cabin. You have lived here all your life.

>x wooden table
A normal wooden table. It is covered with burn marks from all your failed attempts to perform magic.

On the wooden table is a spell book.

>take spell book
Taken.

>x spell book
A leather book giving off the aura of magic. This is where you store your spells.

>x bed
A single size bed worn from generations of use. It is not the most comfortable, but it works.

>n
Forest
Tall trees separate your cabin from the city. You can see a grove of fruit trees. A wooden bridge leads to the Town Square in the North. The Forest Clearing is to the East, and your Cabin is to the South.

>x forest
You can't see any such thing.

>x trees
The apple trees are blooming in the summer sun. You find an apple.

>x trees
The apple trees are blooming in the summer sun.

In the fruit trees is an apple.

>take apple
Taken.

>n
The bridge appears to be broken. It is too dangerous to proceed with the bridge broken.

>x bridge
A rickety old bridge connecting the forest with the town. It appears to be broken.

>e
Forest Clearing
An opening reveals a large stream running parallel to the woods.  A Hermit is sitting on a stone bench next to the stream. The Forest is to the West.

You can see a bench (on which is a Hermit) here.

>x stream
A large stream. It's definetly too long to swim across. You remember swimming here as a child.

>x woods
A collection of trees stretching for miles. You can see the path you were just on.

>x hermit
An old man wearing tattered clothes. He has a long grey beard and a faded robe.

>x bench
A bench carved out of a grey stone. It looks relatively new, and you do not remember when it was moved here.

On the bench is a Hermit.

>talk to hermit
So hungry…湀ܮ

>give apple to hermit
He gratefully accepts the apple.

>talk to hermit
Thank you. I was once a wizard you know. I would be happy to answer any of your questions. 
 You could try asking the Hermit about the Hermit, magic, the city, or the forest.

>ask hermit about hermit
I was once a powerful wizard, but a donkey's kick to the head left me with very little memory of spells and magic words. 
 You could try asking the Hermit about spells or magic.

>ask hermit about spells
Spells are one of the most important parts of a wizard's arsenal. A wizard must know when to use each of their spells. 
 You could try asking the Hermit about the bridge.

>ask hermit about magic
The most powerful type of magic is words. Each word has its own special meaning. By stringing together different word you can create different effects. 
You could try asking the Hermit about magic words or spells.

>ask hermit about magic words
Magic words are the essence of things. By stating an objects" magic word you gain control of it. 
 You could try asking the Hermit about spells.

>e
You can't go that way.

>w
Forest
Tall trees separate your cabin from the city. You can see a grove of fruit trees. A wooden bridge leads to the Town Square in the North. The Forest Clearing is to the East, and your Cabin is to the South.

>e
Forest Clearing
An opening reveals a large stream running parallel to the woods.  A Hermit is sitting on a stone bench next to the stream. The Forest is to the West.

You can see a bench (on which is a Hermit) here.

>talk to hermit
Thank you. I was once a wizard you know. I would be happy to answer any of your questions. 
 You could try asking the Hermit about the Hermit, magic, the city, or the forest.

>ask hermit about city
This city is the capital of Inferna. This was the first city to be built by the powerful wizard Dee Inferna. 
 You could try asking the Hermit about Dee Inferna.

>ask hermit about dee inferna
Dee Inferna was one of the world's most powerful wizards. He saved the world from a countless number of evil threats. Today's wizard ceremony is dedicated to his memory. 
 You could try asking the Hermit about the Wizard Ceremony.

>ask hermit about wizard ceremony
The Wizard Ceremony is an event that has been going on for centuries. I vaguely recall participating when I was a kid. 
 You could try asking the Hermit about the bridge.

>ask hermit abou the bridge
I didn't understand that sentence.

>ask hermit about the bridge
There is no reply.

>ask hermit about bridge
Hmm, the bridge is broken. Try using the spell pontem reficere.
Suddenly, a beacon of light surrounds you. You sort of feel … smarter.㴸鏤

>i
You are carrying:
  a spell book
    Pontem reficere

>w
Forest
Tall trees separate your cabin from the city. You can see a grove of fruit trees. A wooden bridge leads to the Town Square in the North. The Forest Clearing is to the East, and your Cabin is to the South.

>pontem reficere
You see a bright flash. When your eyes return to normal you see a brand new bridge.

>n
Town Square
A large square, near the entrance to the stadium. Informational posters surround the stadium's glass doors. The Forest is to the South, the Mage District is to the East, and the Memorial is to the West.

You can see a glass door and an Official here.

>talk to official
Hello, welcome to the Inferna wizard competition. Your first challenge is in the Bazaar. It is located to the west of the Memorial. Talk to the large man for more information.

>s
Forest
Tall trees separate your cabin from the city. You can see a grove of fruit trees. A wooden bridge leads to the Town Square in the North. The Forest Clearing is to the East, and your Cabin is to the South.

>e
Forest Clearing
An opening reveals a large stream running parallel to the woods.  A Hermit is sitting on a stone bench next to the stream. The Forest is to the West.

You can see a bench (on which is a Hermit) here.

* * *

>take all
(the spell book)
Taken.

>n
Forest
Tall trees separate your cabin from the city. You can see a grove of fruit trees. A wooden bridge leads to the Town Square in the North. The Forest Clearing is to the East, and your Cabin is to the South.

>w
You can't go that way.

>e
Forest Clearing
An opening reveals a large stream running parallel to the woods.  A Hermit is sitting on a stone bench next to the stream. The Forest is to the West.

You can see a bench (on which is a Hermit) here.

>e
You can't go that way.

>x tree
You can't see any such thing.

>x trees
You can't see any such thing.

>w
Forest
Tall trees separate your cabin from the city. You can see a grove of fruit trees. A wooden bridge leads to the Town Square in the North. The Forest Clearing is to the East, and your Cabin is to the South.

>x tre
You can't see any such thing.

>x tree
The apple trees are blooming in the summer sun. You find an apple.

>take apple
Taken.

>e
Forest Clearing
An opening reveals a large stream running parallel to the woods.  A Hermit is sitting on a stone bench next to the stream. The Forest is to the West.

You can see a bench (on which is a Hermit) here.

>eat apple
You're not hungry right now.

>e
You can't go that way.

>give apple to hermit
He gratefully accepts the apple.
You see a flash of light. The Hermit's clothes transform into elegant wizard's robes.

>e
You can't go that way.

* * *

>pontem reficere
You see a bright flash. When your eyes return to normal you see a brand new bridge.

>n
Town Square
A large square, near the entrance to the stadium. You can see the stadium's glass doors and an information board. The Forest is to the South, the Mage District is to the East, and the Memorial is to the West.

You can see a glass door and an Official here.

>i
You are carrying:
  a spell book

>talk to official
Hello, welcome to the Inferna wizard competition. Your first challenge is in the Bazaar. It is located to the west of the Memorial. Talk to the large man for more information.

>x poster
Fireworks show starts at 8:00pm. Fireworks-Ignus Illuminas  is written on the bottom.

Fireworks -  Ignus Illuminas.
Suddenly a beacon of light surrounds you. You sort of feel … smarter.
Ignus Illuminas was added to the spell book.

>n
(first opening the glass door)
It seems to be locked.

>s
Forest
Tall trees separate your cabin from the city. You can see a grove of fruit trees. A wooden bridge leads to the Town Square in the North. The Forest Clearing is to the East, and your Cabin is to the South.

>n
Town Square
A large square, near the entrance to the stadium. You can see the stadium's glass doors and an information board. The Forest is to the South, the Mage District is to the East, and the Memorial is to the West.

You can see a glass door and an Official here.

>x information board
A giant board advertising the Wizard Competition. There are posters are listed describing the days events

>x posters
Fireworks show starts at 8:00pm. Fireworks-Ignus Illuminas  is written on the bottom.

Fireworks -  Ignus Illuminas.
Suddenly a beacon of light surrounds you. You sort of feel … smarter.
Ignus Illuminas was added to the spell book.

>l
Town Square
A large square, near the entrance to the stadium. You can see the stadium's glass doors and an information board. The Forest is to the South, the Mage District is to the East, and the Memorial is to the West.

You can see a glass door and an Official here.

>x information board
A giant board advertising the Wizard Competition. There are posters are listed describing the days events

>take board
That's hardly portable.

>e
Mage District
The city's oldest district and the heart of its magic. Ancient buildings extend in all directions. In the center of the road is a giant statue of the town's founder. The Town Square is to the West.

You can see Statue (on which is a festive box) here.

>w
Town Square
A large square, near the entrance to the stadium. You can see the stadium's glass doors and an information board. The Forest is to the South, the Mage District is to the East, and the Memorial is to the West.

You can see a glass door and an Official here.

>w
Memorial
This area was built in dedication to the town's founder Dee Ignus. There are several murals describing Dee Ignus's many accomplishments. There is a big mural and a colorful mural. The Town Square is in the East and the Bazaar is to the West.

>w
Bazaar
The city's main marketplace. Various shops line the road, each selling different goods. There is a tent titled "Wizard Festival Challenge". Under the tent appears to be a large man guarding a box. The Town Square is to the East.

You can see a large man and a silly box here.

>talk to large man
Welcome wizard, your goal is to take the box from behind me.

>ignus illuminas
Bright red fireworks fill the sky. Distracted, everyone looks up at the colorful lights.

>take box
You quickly take the box while the man is distracted.

>talk to large man
Well done wizard, return to the Offical for your next challenge.

>n
You can't go that way.

>e
Memorial
This area was built in dedication to the town's founder Dee Ignus. There are several murals describing Dee Ignus's many accomplishments. There is a big mural and a colorful mural. The Town Square is in the East and the Bazaar is to the West.

>e
Town Square
A large square, near the entrance to the stadium. You can see the stadium's glass doors and an information board. The Forest is to the South, the Mage District is to the East, and the Memorial is to the West.

You can see a glass door and an Official here.

>talk to official
Nice job! Your next challenge is to get the box in the Mage District.

>e
Mage District
The city's oldest district and the heart of its magic. Ancient buildings extend in all directions. In the center of the road is a giant statue of the town's founder. The Town Square is to the West.

You can see Statue (on which is a festive box) here.

>open box
(the silly box)
You open the silly box, revealing a paper.

>read paper
A torn piece of paper. All it says is  Magnus.

>magnus ventus
A heavy wind flows through the area. The box falls into your hands.

 A beacon of light surrounds you. You feel sort of feel … smarter..
Magnus ventus was added to the spell book.

>open box
Which do you mean, the festive box or the silly box?

>festive
You open the festive box, revealing a glass key.

>take key
Taken.

>e
You can't go that way.

>w
Town Square
A large square, near the entrance to the stadium. You can see the stadium's glass doors and an information board. The Forest is to the South, the Mage District is to the East, and the Memorial is to the West.

You can see a glass door and an Official here.

>talk to official
Brilliant work! Now you have the key to the glass door. But the keyhole appears to be frozen shut.

>magnus ignus
A powerful wave of heat flows through the area.
A beacon of light surrounds you. You sort of feel … smarter.
Magnus ignus was added to the spell book.

>magnus ignus
A powerful wave of heat flows through the area. The keyhole melts open.

>n
(first opening the glass door)
It seems to be locked.

>unlock with key
You can't see any such thing.

>unlock glass door with key
(the glass key)
You unlock the glass door.

>n
(first opening the glass door)

Coliseum
A large area, encompassed by thousands of stands. There are many other wizards in the room. You can see a tall podium in the center of the room. 

Congratulations wizards! You have made it to the final round of the competition. Your final challange is to be the first person to get onto the podium. Your challenge begins NOW!

You can see a glass door here.

>get on podium
You try to climb onto the podium, but a fireball knocks you down. 
 If there was only some way to distract your competitors.

>magnus illuminas
A blinding light fills the room.
A beacon of light surrounds you. You sort of feel … smarter.

>ignus ventus
Warm air circles around your feet. You rise many feet in the air.
A beacon of light surrounds you. You sort of feel … smarter. You add the spell to your spell book.

>ventus illuminas
A light wind swirls around your feet. You feel lighter.
A beacon of light surrounds you. You sort of feel … smarter. You add the spell to your spell book.￿￿

You return to the ground.

>ignus ventus
Warm air circles around your feet. You rise many feet in the air.

>get on podium
You try to climb onto the podium, but a ball of ice knocks you down.

You return to the ground.

>magnus illuminas
A blinding light fills the room.

>ventus illuminas
A light wind swirls around your feet. You feel lighter.

>ignus ventus
Warm air circles around your feet. You rise many feet in the air.

>get on podium
You lean forward and fly onto the podium.

Coliseum (on the tall podium)
A large area, encompassed by thousands of stands. There are many other wizards in the room. You can see a tall podium in the center of the room. 

You can see a glass door here.

You return to the ground.

    *** You have won ***

In that game you scored 0 out of a possible 0, in 63 turns.

Would you like to RESTART, RESTORE a saved game, QUIT or UNDO the last command?

>i
Please give one of the answers above.

Would you like to RESTART, RESTORE a saved game, QUIT or UNDO the last command?

>undo
Coliseum
[Previous turn undone.]

>i
You are carrying:
  Magnus Illuminas
  a glass key
  a festive box (open but empty)
  a silly box (open)
    a paper
  a spell book
    Ventus Illuminas
    Ignus Ventus
    Magnus Ignus
    Magnus Ventus
    Ignus Illuminas

You return to the ground.

>x ventus illuminas
 Ventus Illuminas : Weightless wind.

* * *

>x table
A normal wooden table. It is covered with burn marks from all your failed attempts to perform magic.

On the wooden table is a spell book.

>x spell book
A leather book giving off the aura of magic. This is where you store your spells.

>take book
Taken.

>x bed
A single size bed worn from generations of use. It is not the most comfortable, but it works.

>x house
You can't see any such thing.

>n
Forest
A tranquil forest separating your home from the city. You can see many fruit trees. A wooden bridge leads to the Town Square in the North. The Forest Clearing is to the East, and your Home is to the South.

You can see a fruit tree here.

>x fruit trees
I only understood you as far as wanting to examine the fruit tree.

>take apple
You can't see any such thing.

>x fruit trees
I only understood you as far as wanting to examine the fruit tree.

>x bridge
A rickety old bridge connecting the forest with the town. It appears to be broken.

>e
Forest Clearing
An opening reveals a large stream running parallel to the woods.  A Hermit is sitting on a stone bench next to the stream. The Forest is to the East.

You can see a bench (on which is a Hermit) here.

>x hermit
An old man wearing tattered clothes. He has a long grey beard and a faded robe.

* * *

>x bench
A bench carved out of a grey stone. It looks relatively new, and you do not remember when it was moved here.

On the bench is a Hermit.

>attack hermit
Violence isn't the answer to this one.

>talk to hermit
So hungry…

>give apple to hermit
You can't see any such thing.

>talk to hermit
So hungry…￿￿

>ask hermit
(for the spell book)
(The Hermit first taking the spell book)
The Hermit has better things to do.

>i
You are carrying:
  a spell book

>ask hermit
(for the spell book)
(The Hermit first taking the spell book)
The Hermit has better things to do.

>ask hermit question
I didn't understand that sentence.

>ask hermit about something
There is no reply.

>ask hermit about
I didn't understand that sentence.

>ask hermit about bridge
Hmm, the bridge is broken. Try using the spell pontem reficere.

>e
You can't go that way.

>w
Forest
A tranquil forest separating your home from the city. You can see many fruit trees. A wooden bridge leads to the Town Square in the North. The Forest Clearing is to the East, and your Home is to the South.

You can see a fruit tree here.

>w
You can't go that way.

>n
The bridge appears to be broken. It is too dangerous to proceed with the bridge broken.

>pontem reficere
You see a bright flash. When your eyes return to normal you see a brand new bridge.

>x bridge
A wooden bridge displaying the highest degree of architectural ingenuity.

>n
Town Square
A large square, near the entrance to the stadium. Informational posters surround the stadium's glass doors. The Forest is to the South, the Mage District is to the East, and the Memorial is to the West.

You can see a glass door and an Official here.

>x poster
Beautiful fireworks cover the posters. Fireworks-Ignus Illuminas  is written on the bottom.

>x posters
Beautiful fireworks cover the posters. Fireworks-Ignus Illuminas  is written on the bottom.

>ignus illuminas
Bright red fireworks fill the sky. Distracted, everyone looks up at the colorful lights.
Cool a new spell. You added it to your spell book.

>ignus illuminas
Bright red fireworks fill the sky. Distracted, everyone looks up at the colorful lights.

>x official
A young man dressed in a colorful robe. He looks like he is in charge of the competition.

>x door
The translucent glass is the only thing seperating you from the stadium.

>talk to young man
You can't see any such thing.

>talk to official
Hello, welcome to the Inferna wizard competition. Your first challenge is in the Bazaar. It is located to the west of the Memorial. Talk to the large man for more information.

>w
Memorial
This area was built in dedication to the town's founder Dee Ignus. There are several murals describing Dee Ignus's many accomplishments. There is a big mural and a colorful mural. The Town Square is in the East and the Bazaar is to the West.

>x big mural
The picture shows a tall man controlling the wind. The caption says  Dee Ignus was a powerful man. By simply saying ventus he could control the winds.

>ventus
A light breeze passes through the area.

>x colorful mural
A picture shows a man confronting a large army. The caption says  Dee Ignus was a clever wizard. He often used colorful spells to distract his enemies.

>x spell book
A leather book giving off the aura of magic. This is where you store your spells.

In the spell book are Ignus Illuminas and Pontem reficere.

>w
Bazaar
The city's main marketplace. Various shops line the road, each selling different goods. There is a tent titled "Wizard Festival Challenge". Under the tent appears to be a large man guarding a box. The Town Square is to the East.

You can see a large man and a silly box here.

>x box
 A square box covered with silly pictures of mythical creatures.

>x man
A huge man wearing the Wizard Festival uniform.

>talk to man
Welcome wizard, your goal is to take the box from behind me.

>ignus illuminas
Bright red fireworks fill the sky. Distracted, everyone looks up at the colorful lights.

* * *

>take box
You quickly take the box while the man is distracted.

>undo
Bazaar
[Previous turn undone.]

>undo
Bazaar
[Previous turn undone.]

>take box
You reach your hand out, but the man swats it away.

>ignus illuminas
Bright red fireworks fill the sky. Distracted, everyone looks up at the colorful lights.

* * *

>take box
You quickly take the box while the man is distracted.

>open box
You open the silly box, revealing a paper.

>x paper
A torn piece of paper. All it says is  Magnus.

>x box
 A square box covered with silly pictures of mythical creatures.

In the silly box is a paper.

>magnus
Your body feels weird. Strangely stronger.

>x man
A huge man wearing the Wizard Festival uniform.

>w
You can't go that way.

>e
Memorial
This area was built in dedication to the town's founder Dee Ignus. There are several murals describing Dee Ignus's many accomplishments. There is a big mural and a colorful mural. The Town Square is in the East and the Bazaar is to the West.

>e
Town Square
A large square, near the entrance to the stadium. Informational posters surround the stadium's glass doors. The Forest is to the South, the Mage District is to the East, and the Memorial is to the West.

You can see a glass door and an Official here.

>talk to official
Nice job! Your next challenge is to get the box in the Mage District.

* * *

>e
Mage District
The city's oldest district and the heart of its magic. Ancient buildings extend in all directions. In the center of the road is a giant statue of the town's founder. The Town Square is to the West.

You can see Statue (on which is a festive box) here.

>x statue
 A giant statue of the town's founder, Dee Inferna. The statue stands twenty feet tall. There appears to be a small box on top of the statue.

On Statue is a festive box.

>take box
(the festive box)
It is too high up for you to reach.

>magnus
Your body feels weird. Strangely stronger.

>take box
(the festive box)
It is too high up for you to reach.

>x spell book
A leather book giving off the aura of magic. This is where you store your spells.

In the spell book are Ignus Illuminas and Pontem reficere.

>jump
You jump on the spot, fruitlessly.

>magnus
Your body feels weird. Strangely stronger.

>jump
You jump on the spot, fruitlessly.

>climb statue
I don't think much is to be achieved by that.

>ventus
A light breeze passes through the area. The box moves slightly.

>ventu
That's not a verb I recognise.

>ventus
A light breeze passes through the area. The box moves slightly.

>ventus
A light breeze passes through the area. The box moves slightly.

>magnus
Your body feels weird. Strangely stronger.

>ventus
A light breeze passes through the area. The box moves slightly.

>ignus illuminas
Bright red fireworks fill the sky. Distracted, everyone looks up at the colorful lights.

>ventus illuminas
I only understood you as far as wanting to ventus.

>ventus
A light breeze passes through the area. The box moves slightly.

>ignus ventus
I didn't understand that sentence.

>x ignus illuminas
Ignus Illuminas: Fireworks

>x ventus
You can't see any such thing.

>w
Town Square
A large square, near the entrance to the stadium. Informational posters surround the stadium's glass doors. The Forest is to the South, the Mage District is to the East, and the Memorial is to the West.

You can see a glass door and an Official here.

>go to glass door
You can't see any such thing.

>s
Forest
A tranquil forest separating your home from the city. You can see many fruit trees. A wooden bridge leads to the Town Square in the North. The Forest Clearing is to the East, and your Home is to the South.

You can see a fruit tree here.

>n
Town Square
A large square, near the entrance to the stadium. Informational posters surround the stadium's glass doors. The Forest is to the South, the Mage District is to the East, and the Memorial is to the West.

You can see a glass door and an Official here.

>w
Memorial
This area was built in dedication to the town's founder Dee Ignus. There are several murals describing Dee Ignus's many accomplishments. There is a big mural and a colorful mural. The Town Square is in the East and the Bazaar is to the West.

>e
Town Square
A large square, near the entrance to the stadium. Informational posters surround the stadium's glass doors. The Forest is to the South, the Mage District is to the East, and the Memorial is to the West.

You can see a glass door and an Official here.

>e
Mage District
The city's oldest district and the heart of its magic. Ancient buildings extend in all directions. In the center of the road is a giant statue of the town's founder. The Town Square is to the West.

You can see Statue (on which is a festive box) here.

>w
Town Square
A large square, near the entrance to the stadium. Informational posters surround the stadium's glass doors. The Forest is to the South, the Mage District is to the East, and the Memorial is to the West.

You can see a glass door and an Official here.

>x poster
Beautiful fireworks cover the posters. Fireworks-Ignus Illuminas  is written on the bottom.

>w
Memorial
This area was built in dedication to the town's founder Dee Ignus. There are several murals describing Dee Ignus's many accomplishments. There is a big mural and a colorful mural. The Town Square is in the East and the Bazaar is to the West.

>x mural
Which do you mean, the big mural or the colorful mural?

>big mural
The picture shows a tall man controlling the wind. The caption says  Dee Ignus was a powerful man. By simply saying ventus he could control the winds.

>w
Bazaar
The city's main marketplace. Various shops line the road, each selling different goods. There is a tent titled "Wizard Festival Challenge". Under the tent appears to be a large man guarding a box. The Town Square is to the East.

You can see a large man here.

>e
Memorial
This area was built in dedication to the town's founder Dee Ignus. There are several murals describing Dee Ignus's many accomplishments. There is a big mural and a colorful mural. The Town Square is in the East and the Bazaar is to the West.

* * *

>e
Mage District
The city's oldest district and the heart of its magic. Ancient buildings extend in all directions. In the center of the road is a giant statue of the town's founder. The Town Square is to the West.

You can see Statue (on which is a festive box) here.

>x paper
A torn piece of paper. All it says is  Magnus.

>magnus
Your body feels weird. Strangely stronger.

>attack statue
Violence isn't the answer to this one.

>ventus
A light breeze passes through the area. The box moves slightly.

>big ventus
That's not a verb I recognise.

>ventus magnus
I only understood you as far as wanting to ventus.

>magnus ventus
A heavy wind flows through the area. The box falls into your hands.
Wow, a new spell! Magnus ventus was added to your spell book.

>i
You are carrying:
  a festive box (closed)
  a silly box (open)
    a paper
  a spell book
    Magnus ventus
    Ignus Illuminas
    Pontem reficere

>magnus ventus
A heavy wind flows through the area.
Wow, a new spell! Magnus ventus was added to your spell book.

* * *

>hint
Some players may find the temptation to rely on hints overwhelming, and you may prefer to remove temptation by disabling hints for the rest of this game. If you do so, however, you will not be able to access the hints unless you restart. Do you wish to disable hints? >

>no
Okay - but if you change your mind later you can use the HINTS OFF command to disable hints.

 > How do I fix the bridge?

>n
 > How do I fix the bridge?
 > How do I fix the bridge?

>take spell book
 > How do I fix the bridge?

>n
 > How do I fix the bridge?
 > How do I fix the bridge?

>hint
 > How do I fix the bridge?

>e
 > How do I fix the bridge?

>n
 > How do I fix the bridge?
 > How do I fix the bridge?

>w
 > How do I fix the bridge?

>x bridge
 > How do I fix the bridge?

>x cabit
 > How do I fix the bridge?

>x cabin
 > How do I fix the bridge?

>x city
 > How do I fix the bridge?

>x fruit trees
 > How do I fix the bridge?

>hint
 > How do I fix the bridge?

>þ
 > How do I fix the bridge?

>s
 > How do I fix the bridge?

>þ
 > How do I fix the bridge?

1/4: How might you get a spell to fix the bridge?

Press SPACE to return to the menu or H to reveal another hint.

* * *

 > How do I fix the bridge?
 > How do I fix the bridge?

>n
 > How do I fix the bridge?
 > How do I fix the bridge?

1/4: How might you get a spell to fix the bridge?

Press SPACE to return to the menu or H to reveal another hint.

* * *

 > How do I fix the bridge?
 > How do I fix the bridge?

>e
 > How do I fix the bridge?

* * *

>n
 > How do I fix the bridge?
 > How do I fix the bridge?

>t
 > How do I fix the bridge?

>e
 > How do I fix the bridge?

* * *

 > How do I fix the bridge?

>q
Cabin
A cozy house in the woods. A wooden table is in the center of your room and your bed is in the corner. The Forest is to the North.

On the wooden table is a spell book.

* * *

>no
Okay - but if you change your mind later you can use the HINTS OFF command to disable hints.

 > How do I fix the bridge?

1/4: How might you get a spell to fix the bridge?

Press SPACE to return to the menu or H to reveal another hint.

>h
1/4: How might you get a spell to fix the bridge?

2/4: Is there someone you could ask?

Press SPACE to return to the menu or H to reveal another hint.

>h
1/4: How might you get a spell to fix the bridge?

2/4: Is there someone you could ask?

3/4: If the Hermit is hungry try find some food to give him.

Press SPACE to return to the menu or H to reveal another hint.

>h
1/4: How might you get a spell to fix the bridge?

2/4: Is there someone you could ask?

3/4: If the Hermit is hungry try find some food to give him.

4/4: Did you try asking the Hermit about the bridge?

Press SPACE to return to the menu.

 > How do I fix the bridge?
 > How do I fix the bridge?

* * *

>asdf
That's not a verb I recognise.

>hint
Some players may find the temptation to rely on hints overwhelming, and you may prefer to remove temptation by disabling hints for the rest of this game. If you do so, however, you will not be able to access the hints unless you restart. Do you wish to disable hints? >

* * *

>no
Okay - but if you change your mind later you can use the HINTS OFF command to disable hints.

 > How do I fix the bridge?

>q
Cabin
A cozy house in the woods. A wooden table is in the center of your room and your bed is in the corner. The Forest is to the North.

On the wooden table is a spell book.

I beg your pardon?

>hint
 > How do I fix the bridge?

* * *

>h
1/4: How might you get a spell to fix the bridge?

2/4: Is there someone you could ask?

3/4: If the Hermit is hungry try find some food to give him.

4/4: Did you try asking the Hermit about the bridge?

Press SPACE to return to the menu.

>h
1/4: How might you get a spell to fix the bridge?

2/4: Is there someone you could ask?

3/4: If the Hermit is hungry try find some food to give him.

4/4: Did you try asking the Hermit about the bridge?

Press SPACE to return to the menu.

* * *

>i
You are carrying:
  a windstone

>take spell book
Taken.

>n
Forest
A tranquil forest filled with trees and shrubs. Various rocks and bushes line the dirt road. A wooden bridge leads to the Town Square in the North. The Forest Clearing is to the East, and your Home is to the South.

You can see a rock and a branch here.

>take branch
Taken.

>combine branch with windstone
You wave your hands over the two items. There is a flash of light.

You now have a Folium procellarum.

>undo
Forest
[Previous turn undone.]

>undo
Forest
[Previous turn undone.]

>combine branch with windstone
You wave your hands over the two items. There is a flash of light.

You now have a Folium procellarum.

* * *

>n
Wait, you can't forget your spell book.

>take spell book
Taken.

>n
Forest
A tranquil forest separating your home from the city. You can see many fruit trees. A wooden bridge leads to the Town Square in the North. The Forest Clearing is to the East, and your Home is to the South.

>w
You can't go that way.

>e
Forest Clearing
An opening reveals a large stream running parallel to the woods.  A Hermit is sitting on a stone bench next to the stream. The Forest is to the East.

You can see a bench (on which is a Hermit) here.

>w
Forest
A tranquil forest separating your home from the city. You can see many fruit trees. A wooden bridge leads to the Town Square in the North. The Forest Clearing is to the East, and your Home is to the South.

>n
The bridge appears to be broken. It is too dangerous to proceed with the bridge broken.

* * *

>n
Forest
A tranquil forest separating your home from the city. You can see many fruit trees. A wooden bridge leads to the Town Square in the North. The Forest Clearing is to the East, and your Home is to the South.

>x fruit trees
You find an apple.

>take apple
Taken.

>e
Forest Clearing
An opening reveals a large stream running parallel to the woods.  A Hermit is sitting on a stone bench next to the stream. The Forest is to the East.

You can see a bench (on which is a Hermit) here.

>give apple to hermit
He gratefully accepts the apple.

>talk to hermit
Thank you. I was once a wizard you know. I would be happy to answer any of your questions.

>ask wizard about bridge
You can't see any such thing.

>ask hermit about bridge
Hmm, the bridge is broken. Try using the spell pontem reficere.

>w
Forest
A tranquil forest separating your home from the city. You can see many fruit trees. A wooden bridge leads to the Town Square in the North. The Forest Clearing is to the East, and your Home is to the South.

You can see a fruit trees here.

>pontem reficere
You see a bright flash. When your eyes return to normal you see a brand new bridge.

* * *

>w
Memorial
This area was built in dedication to the town's founder Dee Ignus. There are several murals describing Dee Ignus's many accomplishments. There is a big mural and a colorful mural. The Town Square is in the East and the Bazaar is to the West.

>x big mural
The picture shows a tall man controling the wind. The caption says  Dee Ignus was a powerful man. By simply saying ventus he could control the winds.

>ventus
A light breeze passes through the area.

* * *

>x colorful mural
A picture shows a man confronting a large army. The caption says  Dee Ignus was a clever wizard. He often used colorful spells to distract his enemies.

>w
Bazaar
The city's main marketplace. Various shops line the road, each selling different goods. There is a tent titled "Wizard Festival Challenge". Under the tent appears to be a large man guarding a box. The Town Square is to the East.

You can see a large man and a silly box here.

>take silly box
You reach your hand out, but the man swats it away.

>talk to large man
Welcome wizard, your goal is to take the box from behind me.

>i
You are carrying:
  a spell book
    Pontem reficere

>eat
(the spell book)
That's plainly inedible.

>ignus illuminas
Bright red fireworks fill the sky. Distracted, everyone looks up at the colorful lights.
Cool a new spell. You added it to your spell book.

* * *

>ignus illuminas
Bright red fireworks fill the sky. Distracted, everyone looks up at the colorful lights.

>take box
You reach your hand out, but the man swats it away.

* * *

>open box
You open the silly box, revealing a paper.

>take paper
Taken.

>read paper
A torn piece of paper. All it says is  Magnus.

>w
You can't go that way.

* * *

>e
Mage District
The city's oldest district and the heart of its magic. Ancient buildings extend in all directions. In the center of the road is a giant statue of the town's founder. The Town Square is to the West.

You can see Statue (on which is a festive box) here.

>take box
(the festive box)
It is too high up for you to reach.

>ventus
A light breeze passes through the area. The box moves slightly.

>magnus ventus
A heavy wind flows through the area. The box falls into your hands.

>open box
Which do you mean, the festive box or the silly box?

* * *

>festive
You open the festive box, revealing a glass key.

>take glass key
Taken.

>w
Town Square
A large square, near the entrance to the stadium. Informational posters surround the stadium's glass doors. The Forest is to the South, the Mage District is to the East, and the Memorial is to the West.

You can see a glass door and an Official here.

>talk to official
Brilliant work! Now you have the key to the glass door. But the keyhole appears to be frozen shut.

>unlock door with key
(the glass key)
You unlock the glass door.

>magnus ignus
A powerful wave of heat flows through the area. The keyhole melts open.
Yes! A new spell

>magnus ignus
A powerful wave of heat flows through the area. The keyhole melts open.

>undo
Town Square
[Previous turn undone.]

>undo
Town Square
[Previous turn undone.]

>e
Mage District
The city's oldest district and the heart of its magic. Ancient buildings extend in all directions. In the center of the road is a giant statue of the town's founder. The Town Square is to the West.

You can see Statue here.

>i
You are carrying:
  a glass key
  a festive box (open but empty)
  a paper
  a silly box (open but empty)
  a spell book
    Magnus ventus
    Ignus Illuminas
    Pontem reficere

>mangus ignus
That's not a verb I recognise.

>magnus ignus
A powerful wave of heat flows through the area.
Yes! A new spell

>i
You are carrying:
  a glass key
  a festive box (open but empty)
  a paper
  a silly box (open but empty)
  a spell book
    Magnus Ignus
    Magnus ventus
    Ignus Illuminas
    Pontem reficere

>magnus ignus
A powerful wave of heat flows through the area.

>magnus ignus
A powerful wave of heat flows through the area.

>w
Town Square
A large square, near the entrance to the stadium. Informational posters surround the stadium's glass doors. The Forest is to the South, the Mage District is to the East, and the Memorial is to the West.

You can see a glass door and an Official here.

>magnus ignus
A powerful wave of heat flows through the area. The keyhole melts open.

>unlock door with key
(the glass key)
You unlock the glass door.

>n
(first opening the glass door)

Coliseum
An large arena encompassed by huge stands. The arena is empty except you and your opponent. 

You can see a glass door here.

* * *

>combine branch with windstone
You can't see any such thing.

* * *

>take spell book
Taken.

>n
Forest
Tall trees separate your cabin from the city. You can see a grove of fruit trees. A wooden bridge leads to the Town Square in the North. The Forest Clearing is to the East, and your Cabin is to the South.

>take
(the spell book)
You already have that.

>i
You are carrying:
  a spell book

>x fruit tree
You find an apple.

>l
Forest
A tranquil forest separating your home from the city. You can see many fruit trees. A wooden bridge leads to the Town Square in the North. The Forest Clearing is to the East, and your Home is to the South.

>take apple
Taken.

* * *

>give apple to hermit
He gratefully accepts the apple.

>ask about bridge
You can't see any such thing.

>ask hermit about bridge
Hmm, the bridge is broken. Try using the spell pontem reficere.
Suddenly, a beacon of light surrounds you. You sort of feel … smarter.

>i
You are carrying:
  a spell book
    Pontem reficere

>w
Forest
A tranquil forest separating your home from the city. You can see many fruit trees. A wooden bridge leads to the Town Square in the North. The Forest Clearing is to the East, and your Home is to the South.

* * *

>talk to official
Hello, welcome to the Inferna wizard competition. Your first challenge is in the Bazaar. It is located to the west of the Memorial. Talk to the large man for more information.

>x posters
Beautiful fireworks cover the posters. Fireworks-Ignus Illuminas  is written on the bottom.

Fireworks -  Ignus Illuminas.
Suddenly a beacon of light surrounds you. You sort of feel … smarter.††
Ignus Illuminas was added to the spell book.

>e
Mage District
The city's oldest district and the heart of its magic. Ancient buildings extend in all directions. In the center of the road is a giant statue of the town's founder. The Town Square is to the West.

You can see Statue (on which is a festive box) here.

>magnus ventus
A heavy wind flows through the area. The box falls into your hands.

 A beacon of light surrounds you. You feel sort of feel … smarter..
Magnus ventus was added to the spell book.

>magnus ventus
A heavy wind flows through the area.

>w
Town Square
A large square, near the entrance to the stadium. Informational posters surround the stadium's glass doors. The Forest is to the South, the Mage District is to the East, and the Memorial is to the West.

You can see a glass door and an Official here.

>magnus ventus
A heavy wind flows through the area.

>undo
Town Square
[Previous turn undone.]

>undo
Mage District
[Previous turn undone.]

>undo
Mage District
[Previous turn undone.]

>undo
Town Square
[Previous turn undone.]

>magnus ventus
 A heavy wind flows through the area.

 A beacon of light surrounds you. You feel sort of feel … smarter.
Magnus ventus was added to the spell book.

>magnus ventus
 A heavy wind flows through the area.

>e
Mage District
The city's oldest district and the heart of its magic. Ancient buildings extend in all directions. In the center of the road is a giant statue of the town's founder. The Town Square is to the West.

You can see Statue (on which is a festive box) here.

>magnus ventus
A heavy wind flows through the area. The box falls into your hands.

>i
You are carrying:
  a festive box (closed)
  a spell book
    Magnus Ventus
    Ignus Illuminas
    Pontem reficere

>x magnus ventus
 Magnus Ventus : Heavy wind.

>x ignus illuminas
Ignus Illuminas: Fireworks

>n
You can't go that way.

>i
You are carrying:
  a festive box (closed)
  a spell book
    Magnus Ventus
    Ignus Illuminas
    Pontem reficere

>open box
You open the festive box, revealing a glass key.

>take key
Taken.

>w
Town Square
A large square, near the entrance to the stadium. Informational posters surround the stadium's glass doors. The Forest is to the South, the Mage District is to the East, and the Memorial is to the West.

You can see a glass door and an Official here.

>magnus ignus
A powerful wave of heat flows through the area. The keyhole melts open.
Yes! A new spell

>unlock door with key
(the glass key)
You unlock the glass door.

>n
(first opening the glass door)

Coliseum
A large area, encompassed by thousands of stands. There are many other wizards in the room. You can see a tall podium in the center of the room. 

Congratulations wizards! You have made it to the final round of the competition. Your final challange is to be the first person to get onto the podium. Your challenge begins NOW!

You can see a glass door here.

>magnus illuminas
A blinding light fills the room.
 Cool, a new spell.

>ventus illuminas
A light wind swirls around your feet. You feel lighter.

* * *

>ignus ventus
Warm air circles around your feet. You rise many feet in the air.

>get on podium
You lean forward and fly onto the podium.

Coliseum (on the tall podium)
A large area, encompassed by thousands of stands. There are many other wizards in the room. You can see a tall podium in the center of the room. 

You can see a glass door here.

You return to the ground.

    *** You have won ***

In that game you scored 0 out of a possible 0, in 36 turns.

Would you like to RESTART, RESTORE a saved game, QUIT or UNDO the last command?

* * *

>take
(the spell book)
You already have that.

>take all
(the spell book)
You already have that.

>x fruit tree
The apple trees are blooming in the summer sun. You find an apple.

>x tree
The apple trees are blooming in the summer sun.

In the fruit trees is an apple.

>x fruit trees
The apple trees are blooming in the summer sun.

In the fruit trees is an apple.

>take apple
Taken.

>x apple
A shiny Fuji apple.

>e
Forest Clearing
An opening reveals a large stream running parallel to the woods.  A Hermit is sitting on a stone bench next to the stream. The Forest is to the West.

You can see a bench (on which is a Hermit) here.

>talk to hermit
So hungry…

>x hermit
An old man wearing tattered clothes. He has a long grey beard and a faded robe.

>give apple to hermit
He gratefully accepts the apple.
You see a flash of light. The Hermit's clothes transform into elegant wizard's robes.

>talk to hermit
Thank you. I was once a wizard you know. I would be happy to answer any of your questions. 
 You could try asking the Hermit about the Hermit, magic, the city, or the forest.

* * *

>n
Forest
Tall trees separate your cabin from the city. You can see a grove of fruit trees. A wooden bridge leads to the Town Square in the North. The Forest Clearing is to the East, and your Cabin is to the South.

>x fruit trees
You find an apple.

>x fruit trees
An apple tree.

In the fruit trees is an apple.

>take apple
Taken.

>w
You can't go that way.

* * *

>e
Forest Clearing
An opening reveals a large stream running parallel to the woods.  A Hermit is sitting on a stone bench next to the stream. The Forest is to the East.

You can see a bench (on which is a Hermit) here.

>talk to hermit
So hungry…

>give apple to hermit
He gratefully accepts the apple.

>talk to hermit
Thank you. I was once a wizard you know. I would be happy to answer any of your questions. 
 Try asking the Hermit about the Hermit, magic, the city, or the forest.

>ask hermit about hermit
I was once a powerful wizard, but a donkey's kick left me with very little memory of spells and magic words. 
 Try ask the Hermit about spells or magic.

>ask hermit about spells
Spells are one of the most important parts of a wizard's arsenal. A wizard must know when to use each of their spells. 
 Try asking the Hermit about the bridge.

>ask wizard about magic words
You can't see any such thing.

>ask wizard about magic words
You can't see any such thing.

>ask wizard about spell
You can't see any such thing.

>talk to hermit
Thank you. I was once a wizard you know. I would be happy to answer any of your questions. 
 Try asking the Hermit about the Hermit, magic, the city, or the forest.

* * *

>ask hermit about spells
Spells are one of the most important parts of a wizard's arsenal. A wizard must know when to use each of their spells. 
 Try asking the Hermit about the bridge.

>try asking hermit about magic
That's not a verb I recognise.

>ask hermit about magic
The most powerful type of magic is words. Each word has its own special meaning. By stringing together different word you can create different effects. 
Try asking the Hermit about magic words or spells.

>ask hermit about magic words
Magic words are the secret names of things. By stating an objects secret name you gain control of it. 
 Try ask the Hermit about secret names.

>ask hermit about secret names
Secret names are what the ancient used to call everyday items. 
 Try asking Hermit about the bridge, or spells.

>ask hermit about spells
Spells are one of the most important parts of a wizard's arsenal. A wizard must know when to use each of their spells. 
 Try asking the Hermit about the bridge.

>ask hermit about bridge
Hmm, the bridge is broken. Try using the spell pontem reficere.
Suddenly, a beacon of light surrounds you. You sort of feel … smarter.

>ask hermit about forest
This forest was once the heart of all magic. Many years ago the world's first wizards gathered in this very spot and crafted the first magic words. 
Try asking the hermit about the city.

>ask hermit about city
This city is the capital of Inferna. This was the first city to be built by the powerful wizard Dee Inferna. 
 Try asking the Hermit about Dee Inferna.

>ask hermit about dee inferna
Dee Inferna was one of the world's most powerful wizards. He saved the world from a countless number of evil threats. Today's wizard ceremony is dedicated to his memory. 
 Try asking the Hermit about the bridge.

* * *

>n
Forest
Tall trees separate your cabin from the city. You can see a grove of fruit trees. A wooden bridge leads to the Town Square in the North. The Forest Clearing is to the East, and your Cabin is to the South.

>pontem reficere
You see a bright flash. When your eyes return to normal you see a brand new bridge.

* * *

>n
Town Square
A large square, near the entrance to the stadium. Informational posters surround the stadium's glass doors. The Forest is to the South, the Mage District is to the East, and the Memorial is to the West.

You can see a glass door and an Official here.

>n
(first opening the glass door)
It seems to be locked.

*** Run-time problem P31: Attempt to use a property of the 'nothing' non-object: property asd

>e
Mage District
The city's oldest district and the heart of its magic. Ancient buildings extend in all directions. In the center of the road is a giant statue of the town's founder. The Town Square is to the West.

You can see Statue (on which is a festive box) here.

*** Run-time problem P31: Attempt to use a property of the 'nothing' non-object: property asd

>magnus ventus
A heavy wind flows through the area. The box falls into your hands.

*** Run-time problem P31: Attempt to use a property of the 'nothing' non-object: property asd

>w
Town Square
A large square, near the entrance to the stadium. Informational posters surround the stadium's glass doors. The Forest is to the South, the Mage District is to the East, and the Memorial is to the West.

You can see a glass door and an Official here.

*** Run-time problem P31: Attempt to use a property of the 'nothing' non-object: property asd

>magnus ignus
A powerful wave of heat flows through the area. The keyhole melts open.
Yes! A new spell

*** Run-time problem P31: Attempt to use a property of the 'nothing' non-object: property asd

>magnus ignus
A powerful wave of heat flows through the area. The keyhole melts open.

*** Run-time problem P31: Attempt to use a property of the 'nothing' non-object: property asd

>n
(first opening the glass door)
It seems to be locked.

*** Run-time problem P31: Attempt to use a property of the 'nothing' non-object: property asd

>unlock door with key
(first taking the key hole)
That's hardly portable.

*** Run-time problem P31: Attempt to use a property of the 'nothing' non-object: property asd

>unlock door with glass key
I only understood you as far as wanting to unlock the glass door with the glass door.

>i
You are carrying:
  a festive box (closed)
  a spell book
    Magnus Ignus
    Magnus ventus
    Pontem reficere

*** Run-time problem P31: Attempt to use a property of the 'nothing' non-object: property asd

>open box
You open the festive box, revealing a glass key.

*** Run-time problem P31: Attempt to use a property of the 'nothing' non-object: property asd

>take key
(the glass key)
Taken.

*** Run-time problem P31: Attempt to use a property of the 'nothing' non-object: property asd

>unlock door with key
(the glass key)
You unlock the glass door.

*** Run-time problem P31: Attempt to use a property of the 'nothing' non-object: property asd

>n
(first opening the glass door)

Coliseum
A large area, encompassed by thousands of stands. There are many other wizards in the room. You can see a tall podium in the center of the room. 

Congratulations wizards! You have made it to the final round of the competition. Your final challange is to be the first person to get onto the podium. Your challenge begins NOW!

You can see a glass door and an apple here.

*** Run-time problem P31: Attempt to use a property of the 'nothing' non-object: property asd

>get on podium
You try to climb onto the podium, but a blast of water knocks you down.

*** Run-time problem P31: Attempt to use a property of the 'nothing' non-object: property asd

>climb podium
I don't think much is to be achieved by that.

*** Run-time problem P31: Attempt to use a property of the 'nothing' non-object: property asd

>climb up podium
I don't think much is to be achieved by that.

*** Run-time problem P31: Attempt to use a property of the 'nothing' non-object: property asd

* * *

>n
Town Square
A large square, near the entrance to the stadium. Informational posters surround the stadium's glass doors. The Forest is to the South, the Mage District is to the East, and the Memorial is to the West.

You can see a glass door and an Official here.

>e
Mage District
The city's oldest district and the heart of its magic. Ancient buildings extend in all directions. In the center of the road is a giant statue of the town's founder. The Town Square is to the West.

You can see Statue (on which is a festive box) here.

* * *

>magnus ventus
A heavy wind flows through the area. The box falls into your hands.

>open box
You open the festive box, revealing a glass key.

* * *

>unlock door with key
(the glass key)
You unlock the glass door.

>n
(first opening the glass door)

Coliseum
A large area, encompassed by thousands of stands. There are many other wizards in the room. You can see a tall podium in the center of the room. 

Congratulations wizards! You have made it to the final round of the competition. Your final challange is to be the first person to get onto the podium. Your challenge begins NOW!

You can see a glass door and an apple here.

>get on podium
You try to climb onto the podium, but a fireball knocks you down.

>get on podium
You try to climb onto the podium, but a ball of ice knocks you down.

>get on podium
You try to climb onto podium, but a bolt of lightning knocks you down.

>get on podium
You try to climb onto the podium, but a blast of water knocks you down.

>magnus illuminas
A blinding light fills the room.
 Cool, a new spell.

>pratum inferno
That's not a verb I recognise.

>magnus illuminas
A blinding light fills the room.

* * *

>jump
You jump on the spot, fruitlessly.

>jump
You jump on the spot, fruitlessly.

>get on podium
You try to climb onto podium, but a bolt of lightning knocks you down.

>magnus illuminas
A blinding light fills the room.

>undo
Coliseum
[Previous turn undone.]

>ignus illuminas
Bright red fireworks fill the sky. Distracted, everyone looks up at the colorful lights.
Cool a new spell. You added it to your spell book.

>jump
You jump on the spot, fruitlessly.

>get on podium
You try to climb onto the podium, but a ball of ice knocks you down.

>magnus illuminas
A blinding light fills the room.

>ignus ventus
Warm air circles around your feet. You rise many feet in the air.

>get on podium
You lean forward and fly onto the podium.

Coliseum (on the tall podium)
A large area, encompassed by thousands of stands. There are many other wizards in the room. You can see a tall podium in the center of the room. 

You can see a glass door and an apple here.

You return to the ground.

    *** You have won ***

In that game you scored 0 out of a possible 0, in 30 turns.

Would you like to RESTART, RESTORE a saved game, QUIT or UNDO the last command?