It's a beautiful day in the land of Inferna. You jump out of bed, excitement flowing through your veins. It's finally your fifteenth birthday and you can now participate in wizard battles at the Coliseum. There's so much for you to learn about magic. Let's go!

You find yourself at Home.

WizardBattle
An Interactive Fiction by Cameron Haseyama
Release 1 / Serial number 131006 / Inform 7 build 6G60 (I6/v6.32 lib 6/12N) SD

Home
A cozy house in the woods and your home since birth. A wooden table is in the center of your room and your bed is in the corner. There is a bookshelf on in the corner. There is a door in the north leading to the Forest.

On the wooden table are a note and a spell book.

I beg your pardon?

>n
Forest
A tranquil forest filled with trees and shrubs. Various rocks and bushes line the dirt road. A wooden bridge leads to the Town Square in the North. The Forest Clearing is to the East, and your Home is to the South.

>n
(first opening the Bridge)

Town Square
A large square, near the entrance to the stadium. It is filled with local wizards and fans. Large torches line the stadium's glass door. The Forest is to the South, the Mage District is to the East, and the Bazzar is to the West.

You can see a glass door and a Bridge here.

* * *

>n
Forest
A tranquil forest filled with trees and shrubs. Various rocks and bushes line the dirt road. A wooden bridge leads to the Town Square in the North. The Forest Clearing is to the East, and your Home is to the South.

>e
Forest Clearing
An opening reveals a large stream running parallel to the woods. It runs from the top of a mountain all the way to the city. Next to the stream is stone bench where travelers rest. The Forest is to the East.

You can see a bench (on which is a Hermit) here.

* * *

>n
Forest
A tranquil forest filled with trees and shrubs. Various rocks and bushes line the dirt road. A wooden bridge leads to the Town Square in the North. The Forest Clearing is to the East, and your Home is to the South.

>w
You can't go that way.

>e
Forest Clearing
An opening reveals a large stream running parallel to the woods. It runs from the top of a mountain all the way to the city. A Hermit is sitting on a stone bench next to the stream. The Forest is to the East.

You can see a bench (on which is a Hermit) here.

>talk to hermit
Fix, reficere, fix.

* * *

>x note
Happy Birthday Atlas,

We know you're excited to go compete in wizard battles so we'll make this short. Don't forget your spell book. That's where you store your magic spells. Make sure you have it at all times. Also, the Coliseum is to the North so don't get lost.

From, your parents.

>take spell book
Taken.

* * *

>n
Wait, you can't forget your spell book.

* * *

>n
Forest
A tranquil forest filled with trees and shrubs. Various rocks and bushes line the dirt road. A wooden bridge leads to the Town Square in the North. The Forest Clearing is to the East, and your Home is to the South.

>n
It's too dangerous to go north with the bridge broken.

>pontem reficere
You see a bright flash. When you're eyes return to normal you see a brand new bridge.

* * *

>n
Town Square
A large square, near the entrance to the stadium. It is filled with local wizards and fans. Large torches line the stadium's glass door. The Forest is to the South, the Mage District is to the East, and the Bazzar is to the West.

You can see a glass door here.

>n
(first opening the glass door)

Lobby
The waiting room for the Coliseum. This is where wizards wait before their battles. There is a reception desk on one side of the room, and a couch in the other. The Coliseum is to the North and the Town Square is to the South.

You can see a glass door here.

* * *

>n
Are you sure? Once you enter the battle with start and you won't be able to come back.

>yes
Coliseum
An large arena encompassed by huge stands. The arena is empty except you and your opponent.

>s
Lobby
The waiting room for the Coliseum. This is where wizards wait before their battles. There is a reception desk on one side of the room, and a couch in the other. The Coliseum is to the North and the Town Square is to the South.

You can see a glass door here.

* * *

>n
Forest
A tranquil forest filled with trees and shrubs. Various rocks and bushes line the dirt road. A wooden bridge leads to the Town Square in the North. The Forest Clearing is to the East, and your Home is to the South.

>drop spell book
Dropped.

>s
Home
A cozy house in the woods and your home since birth. A wooden table is in the center of your room and your bed is in the corner. Light flows in through the window. There is a door in the north leading to the Forest.

On the wooden table is a note.

>n
Wait, you can't forget your spell book.

>take apple
Taken.

>e
Forest Clearing
An opening reveals a large stream running parallel to the woods. It runs from the top of a mountain all the way to the city. A Hermit is sitting on a stone bench next to the stream. The Forest is to the East.

You can see a bench (on which is a Hermit) here.

>give apple to hermit
The Hermit gratefully accepts the apple. He eats it in one bite.

>talk to hermit
Wizzarrd know sppels.

 Maybe you are try asking or telling him about something.

* * *

>n
Wait, you can't forget your spell book.

>e
Forest Clearing
An opening reveals a large stream running parallel to the woods. It runs from the top of a mountain all the way to the city. A Hermit is sitting on a stone bench next to the stream. The Forest is to the East.

You can see a bench (on which is a Hermit) here.

* * *

>talk to hermit
Grrwwll, hungry.

>e
You can't go that way.

>w
Forest
A tranquil forest filled with trees and shrubs. Various rocks and bushes line the dirt road. A wooden bridge leads to the Town Square in the North. The Forest Clearing is to the East, and your Home is to the South.

>take apple
Taken.

* * *

>talk to hermit
Grrwwll, hungry.

>give apple to hermit
The Hermit gratefully accepts the apple. He eats it in one bite.

>talk to hermit
Wizzarrd know sppels.

* * *

>e
Forest Clearing
An opening reveals a large stream running parallel to the woods. It runs from the top of a mountain all the way to the city. A Hermit is sitting on a stone bench next to the stream. The Forest is to the East.

You can see a bench (on which is a Hermit) here.

>x bench
A bench carved out of a grey stone. It looks relatively new, and you do not remember when it was moved here.

>get on bench
That's not something you can enter.

>get off bench
But you aren't on the bench at the moment.

* * *

>e
Forest Clearing
An opening reveals a large stream running parallel to the woods. It runs from the top of a mountain all the way to the city. A Hermit is sitting on a stone bench next to the stream. The Forest is to the East.

You can see a bench (on which is a Hermit) here.

>talk to Hermit
Thank you. I was once a wizard, now I live the life of a hermit.

* * *

>n
Wait, you can't forget your spell book.

>x trees
A variety of trees, ranging in breeds. Several of them appear to be apple trees.

In the trees is an apple.

>take apple
Taken.

>x apple
A shiny Fuji apple. Looks delicious.

>eat apple
You're not hungry right now. Maybe later.

* * *

>x trees
A variety of trees, ranging in breeds. Several of them appear to be apple trees.

In the trees is an apple.

>x apple tree
A large tree covered with fruit.

* * *

>n
Wait, you can't forget your spell book.

>pontem reficere
You see a bright flash. When you're eyes return to normal you see a brand new bridge.

>x spell book
You can't see any such thing.

>s
Home
A cozy house in the woods and your home since birth. A wooden table is in the center of your room and your bed is in the corner. Light flows in through the window. There is a door in the north leading to the Forest.

On the wooden table are a note and a spell book (in which is Pontem reficere).

>x spell book
A leather book giving off the aura of magic.

In the spell book is Pontem reficere.

>x pontem reficere
pontem reficere: fix bridge

>take spell book
Taken.

* * *

>n
Wait, you can't forget your spell book.

>x bridge
A rickety old bridge connecting the forest with the town. It appears to be broken.

>x fixing bridge
A rickety old bridge connecting the forest with the town. It appears to be broken.

>w
You can't go that way.

* * *

>e
Forest Clearing
An opening reveals a large stream running parallel to the woods. It runs from the top of a mountain all the way to the city. A Hermit is sitting on a stone bench next to the stream. The Forest is to the East.

You can see a bench (on which is a Hermit) here.

>ask hermit about bridge
Broken. Reficere pontem.

* * *

>n
Wait, you can't forget your spell book.

>n
Wait, you can't forget your spell book.

* * *

>n
It's too dangerous to go north with the bridge broken.

>pontem recifere
I didn't understand that sentence.

>pontem reficere
You see a bright flash. When you're eyes return to normal you see a brand new bridge.

* * *

>take spell book
Taken.

>n
Forest
A tranquil forest filled with trees and shrubs. Various rocks and bushes line the dirt road. A wooden bridge leads to the Town Square in the North. The Forest Clearing is to the East, and your Home is to the South.

You can see a branch here.

>pontem reficere
You see a bright flash. When you're eyes return to normal you see a brand new bridge.

* * *

>n
Town Square
A large square, near the entrance to the stadium. It is filled with local wizards and fans. Large torches line the stadium's glass door. The Forest is to the South, the Mage District is to the East, and the Bazzar is to the West.

You can see a glass door here.

>take torch
You can't see any such thing.

>take torch
You can't see any such thing.

* * *

>n
Forest
A tranquil forest filled with trees and shrubs. Various rocks and bushes line the dirt road. A wooden bridge leads to the Town Square in the North. The Forest Clearing is to the East, and your Home is to the South.

You can see a branch here.

>pontem recifere
I didn't understand that sentence.

* * *

>yes
Taken

>i
You are carrying:
  a torch
  a spell book
    Pontem reficere

>undo
Town Square
[Previous turn undone.]

>undo
Forest
[Previous turn undone.]

>n
Town Square
A large square, near the entrance to the stadium. It is filled with local wizards and fans. Large torches line the stadium's glass door. The Forest is to the South, the Mage District is to the East, and the Bazzar is to the West.

Thousands of torches brightly flicker in the daylight. You can counts thousands of them. The city probably wouldn't notice one missing.

You can also see a glass door here.

* * *

>yes
Taken

>s
Forest
A tranquil forest filled with trees and shrubs. Various rocks and bushes line the dirt road. A wooden bridge leads to the Town Square in the North. The Forest Clearing is to the East, and your Home is to the South.

You can see a branch here.

>take branch
Taken.

>n
Town Square
A large square, near the entrance to the stadium. It is filled with local wizards and fans. Large torches line the stadium's glass door. The Forest is to the South, the Mage District is to the East, and the Bazzar is to the West.

You can see a glass door here.

>e
Mage District
The city's oldest district and the heart of its magic. The most powerful wizards in the city often meet here to discuss wizardly things. Large stone buildings form a circle around the meeting grounds. Here you see a Mystic and stone table. The Town Square is to the West.

You can see a stone table here.

* * *

>n
Forest
A tranquil forest filled with trees and shrubs. Various rocks and bushes line the dirt road. A wooden bridge leads to the Town Square in the North. The Forest Clearing is to the East, and your Home is to the South.

You can see a branch here.

>take branch
Taken.

* * *

>y
Taken

>e
Mage District
The city's oldest district and the heart of its magic. The most powerful wizards in the city often meet here to discuss wizardly things. Large stone buildings form a circle around the meeting grounds. Here you see a Mystic and stone table. The Town Square is to the West.

You can see a stone table here.

>put torch on stone table
You put the torch on the stone table.

>put branch on table
You put the branch on the stone table.

>combine torch with branch
You wave your hands over the items and poof. Pratum inferno appears in a ball of green fire.

>i
You are carrying:
  a spell book
    Pratum inferno
    Pontem reficere

I beg your pardon?

* * *

>n
Town Square
A large square, near the entrance to the stadium. It is filled with local wizards and fans. Large torches line the stadium's glass door. The Forest is to the South, the Mage District is to the East, and the Bazzar is to the West.

Thousands of torches brightly flicker in the daylight. You can counts thousands of them. The city probably wouldn't notice one missing.

You can also see a glass door here.

>e
Mage District
The city's oldest district and the heart of its magic. The most powerful wizards in the city often meet here to discuss wizardly things. Large stone buildings form a circle around the meeting grounds. Here you see a Mystic and stone table. The Town Square is to the West.

You can see a stone table here.

>put branch on table
You put the branch on the stone table.

>e
You can't go that way.

>w
Town Square
A large square, near the entrance to the stadium. It is filled with local wizards and fans. Large torches line the stadium's glass door. The Forest is to the South, the Mage District is to the East, and the Bazzar is to the West.

Thousands of torches brightly flicker in the daylight. You can counts thousands of them. The city probably wouldn't notice one missing.

You can also see a glass door here.

>take torch
You might get in trouble. Are you sure?

* * *

>yes
Taken

>e
Mage District
The city's oldest district and the heart of its magic. The most powerful wizards in the city often meet here to discuss wizardly things. Large stone buildings form a circle around the meeting grounds. Here you see a Mystic and stone table. The Town Square is to the West.

You can see a stone table (on which is a branch) here.

>put branch on table
(first taking the branch)

You put the branch on the stone table.

>put torch on table
You put the torch on the stone table.

>combine
(the spell book with the spell book)

>combine torch with branch
You wave your hands over the items and poof. Pratum inferno appears in a ball of green fire.

 You add the spell to your spell book

I beg your pardon?

>i
You are carrying:
  a spell book
    Pratum inferno
    Pontem reficere

>x pratum inferno
pratum inferno: meadow of flame

>x pontem
pontem reficere: fix bridge