It's a beautiful day in the land of Inferna. You slowly get out of bed and read a note. It says,
 Dear Atlas,

Happy birthday! We know you're excited to go compete in wizard festival so we'll make this short. Use your superb wit and newfound magic to win this year. Have fun and be safe.

From, Mom and Dad.

You find yourself at Home.

WizardBattle
An Interactive Fiction by Cameron Haseyama
Release 1 / Serial number 131010 / Inform 7 build 6G60 (I6/v6.32 lib 6/12N) SD

Home
A cozy house in the woods and your home since birth. A wooden table is in the center of your room and your bed is in the corner. The Forest is to the North.

On the wooden table is a spell book.

I beg your pardon?

I beg your pardon?

>n
Wait, you can't forget your spell book.

* * *

>take spell book
Taken.

>n
Forest
A tranquil forest separating your home from the city. You can see many trees. A wooden bridge leads to the Town Square in the North. The Forest Clearing is to the East, and your Home is to the South.

You can see a trees (in which is an apple) here.

>take apple
Taken.

* * *

>x note
Dear Atlas,

We know you're excited to go compete in wizard festival so we'll make this short. Don't forget your spell book. That's where you store your magic spells. Make sure you have it at all times. Also, the Town Square is to the North so don't get lost.

From, Mom and Dad.

>take book
Taken.

* * *

>i
You are carrying:
  a spell book

>tn
That's not a verb I recognise.

>n
Forest
A tranquil forest filled with trees and shrubs. Various rocks and bushes line the dirt road. A wooden bridge leads to the Town Square in the North. The Forest Clearing is to the East, and your Home is to the South.

>e
Forest Clearing
An opening reveals a large stream running parallel to the woods.  A Hermit is sitting on a stone bench next to the stream. The Forest is to the East.

You can see a bench (on which is a Hermit) here.

>talk to hermit
I was once an wizard you know.

 Hmm, maybe he could teach you about magic.

>ask about magic
You can't see any such thing.

>ask about bridge
You can't see any such thing.

>ask hermit about magic
Magic is composed of two words. These words can be found all over the world. Different combinations of words can have different affects.

 Interesting, does he know about the bridge?

* * *

>x note
Dear Atlas,

We know you're excited to go compete in wizard festival so we'll make this short. Don't forget your spell book. That's where you store your magic spells. Make sure you have it at all times. Also, the Town Square is to the North so don't get lost.

From, Mom and Dad.

>take spell book
Taken.

>n
Forest
A tranquil forest filled with trees and shrubs. Various rocks and bushes line the dirt road. A wooden bridge leads to the Town Square in the North. The Forest Clearing is to the East, and your Home is to the South.

>take
(the apple)
Taken.

>e
Forest Clearing
An opening reveals a large stream running parallel to the woods. It runs from the top of a mountain all the way to the city. A Hermit is sitting on a stone bench next to the stream. The Forest is to the East.

You can see a bench (on which is a Hermit) here.

>talk to hermit
Grrwwll, hungry.

>Combining it with is an action applying to two things.
That's not a verb I recognise.

>give apple to hermit
The Hermit gratefully accepts the apple. He eats it in one bite.

>talk to hermit
Wizzarrd know sppels.

 Maybe you can try asking or telling him about something.

>ask about bridge
You can't see any such thing.

>ask hermit about gridge
There is no reply.

>ask hermit about bridge
The pontem? Pontem

>w
Forest
A tranquil forest filled with trees and shrubs. Various rocks and bushes line the dirt road. A wooden bridge leads to the Town Square in the North. The Forest Clearing is to the East, and your Home is to the South.

>pontem reficere
You see a bright flash. When you're eyes return to normal you see a brand new bridge.

>n
Town Square
A large square, near the entrance to the stadium. It is filled with local wizards and fans. Large torches line the stadium's glass door. The Forest is to the South, the Mage District is to the East, and the Bazzar is to the West.

You can see a glass door here.

* * *

>ventus
A light breeze passes through the area.

* * *

>x table
A normal wooden table. It is covered with burn marks from all your failed attempts to perform magic.

On the wooden table are a note and a spell book.

>x note
Dear Atlas,

We know you're excited to go compete in wizard festival so we'll make this short. Don't forget your spell book. That's where you store your magic spells. Make sure you have it at all times. Also, the Town Square is to the North so don't get lost.

From, Mom and Dad.

>x spell book
A leather book giving off the aura of magic. This is where you store your spells.

>take spell book
Taken.

>n
Forest
A tranquil forest separating your home from the city. You can see many fruit trees. A wooden bridge leads to the Town Square in the North. The Forest Clearing is to the East, and your Home is to the South.

You can see a fruit trees here.

>drop spell book
Don't do that! You need this.

>e
Forest Clearing
An opening reveals a large stream running parallel to the woods.  A Hermit is sitting on a stone bench next to the stream. The Forest is to the East.

You can see a bench (on which is a Hermit) here.

>talk  to man
You can't see any such thing.

>talk to hermit
Thank you. Did you know I was once a wizard?

>ask hermit about bridge
Hmm, the bridge is broken. Try using the spell pontem reficere.

>ask hermit how to fix bridge
I didn't understand that sentence.

>e
You can't go that way.

>w
Forest
A tranquil forest separating your home from the city. You can see many fruit trees. A wooden bridge leads to the Town Square in the North. The Forest Clearing is to the East, and your Home is to the South.

You can see a fruit trees here.

>pontem reficere
You see a bright flash. When you're eyes return to normal you see a brand new bridge.

>n
Town Square
A large square, near the entrance to the stadium. It is filled with local wizards and fans. Large torches line the stadium's glass door. You can see various posters for the competition. The Forest is to the South, the Mage District is to the East, and the Bazzar is to the West.

You can see a glass door, a torch and an Official here.

>talk to official
Hello, welcome to the Inferna wizard competition. The first challenge is unlocking the glass door behind me. The keys to opening the door are in the Mage District and Bazaar.

>x posters
Beautiful fireworks cover the posters,  Ignus Illuminas  is written on the bottom.

>w
Bazaar
The city's main marketplace. Various shops line the road, each selling different goods. There is a large man standing in under a tent called "Wizard Festival Challenge". The Town Square is to the East.

You can see a large man and a silly box here.

>talk to man
Welcome wizard, your goal is to take the box from behind me.

>take box
You reach your hand out, but the man swats it away.

>ignus illuminas
Bright red fireworks fill the sky.
Cool a new spell. You added it to your spell book.

>take silly box
You quickly take the box while the man is distracted.

* * *

>i
You are carrying:
  a windstone

* * *

>take spell book
Taken.

>n
Forest
A tranquil forest separating your home from the city. You can see many fruit trees. A wooden bridge leads to the Town Square in the North. The Forest Clearing is to the East, and your Home is to the South.

You can see a fruit trees (in which is an apple) here.

>take branch
Taken.

>pontem reficere
You see a bright flash. When you're eyes return to normal you see a brand new bridge.

>n
Town Square
A large square, near the entrance to the stadium. It is filled with local wizards and fans. Large torches line the stadium's glass door. The Forest is to the South, the Mage District is to the East, and the Bazzar is to the West.

Thousands of torches brightly flicker in the daylight. You can counts thousands of them. The city probably wouldn't notice one missing.

You can also see a glass door here.

>take torch
You might get in trouble. Are you sure?

>yes
Taken

>n
(first opening the glass door)

Lobby
The waiting room for the Coliseum. This is where wizards wait before their battles. There is a reception desk on one side of the room, and a couch in the other. The Coliseum is to the North and the Town Square is to the South.

You can see a glass door here.

>n
Are you sure? Once you enter the battle with start and you won't be able to come back.

>y
Coliseum
An large arena encompassed by huge stands. The arena is empty except you and your opponent. 

You can see Locke here.

>cast pratum inferno on Locke
I only understood you as far as wanting to cast pratum inferno.

>cast pratum inferno
You must supply a noun.

* * *

>n
Forest
A tranquil forest separating your home from the city. You can see many fruit trees. A wooden bridge leads to the Town Square in the North. The Forest Clearing is to the East, and your Home is to the South.

You can see a fruit trees (in which is an apple) here.

>n
The bridge appears to be broken. It is too dangerous to go north with the bridge broken.

>e
Forest Clearing
An opening reveals a large stream running parallel to the woods.  A Hermit is sitting on a stone bench next to the stream. The Forest is to the East.

You can see a bench (on which is a Hermit) here.

* * *

>n
The bridge appears to be broken. It is too dangerous to go north with the bridge broken.

>pontem reficere
You see a bright flash. When your eyes return to normal you see a brand new bridge.

* * *

>n
Town Square
A large square, near the entrance to the stadium. Informational posters surround the stadium's glass doors. The Forest is to the South, the Mage District is to the East, and the Memorial is to the West.

You can see a glass door and an Official here.

>walk to official
You can't see any such thing.

>talk to official
Hello, welcome to the Inferna wizard competition. Your first challenge is in the Bazaar. It is located to the west of the Memorial. Talk to the large man for more information.

* * *

>w
Memorial
This area was built in dedication to the town's founder Dee Ignus. There are several murals describing Dee Ignus's many accomplishments. There is a big mural and a colorful mural. The Town Square is in the East and the Bazaar is to the West.

>x colorful mural
A picture shows a man confronting a large army. The caption says  Dee Ignus was a clever wizard. He used colorful spells to distract his enemies.

>w
Bazaar
The city's main marketplace. Various shops line the road, each selling different goods. There is a tent titled "Wizard Festival Challenge". Under the tent appears to be a large man guarding a box. The Town Square is to the East.

You can see a large man and a silly box here.

>ignus illuminas
Bright red fireworks fill the sky. Everyone looks up at the colorful lights.
Cool a new spell. You added it to your spell book.

* * *

>n
Forest
A tranquil forest separating your home from the city. You can see many fruit trees. A wooden bridge leads to the Town Square in the North. The Forest Clearing is to the East, and your Home is to the South.

You can see a fruit trees (in which is an apple) here.

>e
Forest Clearing
An opening reveals a large stream running parallel to the woods.  A Hermit is sitting on a stone bench next to the stream. The Forest is to the East.

You can see a bench (on which is a Hermit) here.

>talk to hermit
Thank you. Did you know I was once a wizard?

>w
Forest
A tranquil forest separating your home from the city. You can see many trees. A wooden bridge leads to the Town Square in the North. The Forest Clearing is to the East, and your Home is to the South.

You can see a trees here.

>x trees
Trees blossom in the forest. You can see an apple here.

* * *

>n
Forest
A tranquil forest separating your home from the city. You can see many fruit trees. A wooden bridge leads to the Town Square in the North. The Forest Clearing is to the East, and your Home is to the South.

You can see a fruit trees (in which is an apple) here.

>pontem reficere
You see a bright flash. When your eyes return to normal you see a brand new bridge.

* * *

>n
Town Square
A large square, near the entrance to the stadium. Informational posters surround the stadium's glass doors. The Forest is to the South, the Mage District is to the East, and the Memorial is to the West.

You can see a glass door and an Official here.

>e
Mage District
The city's oldest district and the heart of its magic. Ancient buildings extend in all directions. In the center of the road is a giant statue of the town's founder. The Town Square is to the West.

You can see Statue (on which is a festival box) here.

>w
Town Square
A large square, near the entrance to the stadium. It is filled with local wizards and fans. Various posters surround the stadium's glass doors. The Forest is to the South, the Mage District is to the East, and the Bazzar is to the West.

You can see a glass door, a torch and an Official here.

>w
Bazaar
The city's main marketplace. Various shops line the road, each selling different goods. There is a tent titled "Wizard Festival Challenge". Under the tent appears to be a large man guarding a box. The Town Square is to the East.

You can see a large man and a silly box here.

* * *

>e
Mage District
The city's oldest district and the heart of its magic. Ancient buildings extend in all directions. In the center of the road is a giant statue of the town's founder. The Town Square is to the West.

You can see Statue (on which is a festival box) here.

>ventus
A light breeze passes through the area. The box moves slightly

>ventus
A light breeze passes through the area. The box moves slightly

>w
Town Square
A large square, near the entrance to the stadium. Informational posters surround the stadium's glass doors. The Forest is to the South, the Mage District is to the East, and the Memorial is to the West.

You can see a glass door and an Official here.

* * *

>e
Mage District
The city's oldest district and the heart of its magic. Ancient buildings extend in all directions. In the center of the road is a giant statue of the town's founder. The Town Square is to the West.

You can see Statue (on which is a festival box) here.

>magnus ventus
A heavy wind flows through the area. The box falls into your hands.
Cool a new spell. Let's add it to the spell book

>undo
Mage District
[Previous turn undone.]

>w
Town Square
A large square, near the entrance to the stadium. Informational posters surround the stadium's glass doors. The Forest is to the South, the Mage District is to the East, and the Memorial is to the West.

You can see a glass door and an Official here.

>e
Mage District
The city's oldest district and the heart of its magic. Ancient buildings extend in all directions. In the center of the road is a giant statue of the town's founder. The Town Square is to the West.

You can see Statue (on which is a festival box) here.

>w
Town Square
A large square, near the entrance to the stadium. Informational posters surround the stadium's glass doors. The Forest is to the South, the Mage District is to the East, and the Memorial is to the West.

You can see a glass door and an Official here.

* * *

>e
Mage District
The city's oldest district and the heart of its magic. Ancient buildings extend in all directions. In the center of the road is a giant statue of the town's founder. The Town Square is to the West.

You can see Statue (on which is a festival box) here.

>magnus
Your body feels strange. Almost tingly.

>magnus ventus
A heavy wind flows through the area. The box falls into your hands.
Cool a new spell. Let's add it to the spell book

>magnus ventus
A heavy wind flows through the area.
Cool a new spell. Let's add it to the spell book

>i
You are carrying:
  a festival box
  a spell book
    Magnus ventus
    Pontem reficere

>magnus ventus
A heavy wind flows through the area.
Cool a new spell. Let's add it to the spell book

>magnus ventus
A heavy wind flows through the area.
Cool a new spell. Let's add it to the spell book

* * *

>n
Town Square
A large square, near the entrance to the stadium. Informational posters surround the stadium's glass doors. The Forest is to the South, the Mage District is to the East, and the Memorial is to the West.

You can see a glass door and an Official here.

>mysticum illuminas
The area fills with a blinding light.
Cool a new spell. You added it to your spell book.

>ignus illuminas
That's not a verb I recognise.

>e
Mage District
The city's oldest district and the heart of its magic. Ancient buildings extend in all directions. In the center of the road is a giant statue of the town's founder. The Town Square is to the West.

You can see Statue (on which is a festival box) here.

>w
Town Square
A large square, near the entrance to the stadium. It is filled with local wizards and fans. Large torches line the stadium's glass door. You can see various posters for the competition. The Forest is to the South, the Mage District is to the East, and the Bazzar is to the West.

You can see a glass door, a torch and an Official here.

>x posters
Beautiful fireworks cover the posters,  Ignus Illuminas  is written on the bottom.

* * *

>pontem reficere
You see a bright flash. When your eyes return to normal you see a brand new bridge.

>take rock
Taken.

>take branch
Taken.

>n
Town Square
A large square, near the entrance to the stadium. It is filled with local wizards and fans. Large torches line the stadium's glass door. The Forest is to the South, the Mage District is to the East, and the Bazzar is to the West.

Thousands of torches brightly flicker in the daylight. You can counts thousands of them. The city probably wouldn't notice one missing.

You can also see a glass door here.

* * *

>take torch
You might get in trouble. Are you sure?

>y
Taken

>combine torch with branch
You wave your hands over the two items. There is a flash of light.

You now have a Pratum inferno.

>i
You are carrying: 
a rock
a spell book
a windstone
(Health: 100)

>x spell book
A leather book giving off the aura of magic. This is where you store your spells.

In the spell book are Pratum inferno and Pontem reficere.

>n
(first opening the glass door)

Lobby
The waiting room for the Coliseum. This is where wizards wait before their battles. There is a reception desk on one side of the room, and a couch in the other. The Coliseum is to the North and the Town Square is to the South.

You can see a glass door here.

* * *

>y
Coliseum
An large arena encompassed by huge stands. The arena is empty except you and your opponent. 

You can see Locke here.

>cast pratum inferno
*** Run-time problem P31: Attempt to use a property of the 'nothing' non-object: property maximum damage

Variable unavailable for this action, activity or rulebook: internal ID number 20080/0

>undo
Coliseum
[Previous turn undone.]

>i
You are carrying: 
a rock
a spell book
a windstone
(Health: 100)

>x locke
 This guy looks like he is your competitor. He is average hight with blonde hair. He looks like a beginner wizard like you.

(Health: 100)

* * *

>pontem reficere
You see a bright flash. When your eyes return to normal you see a brand new bridge.

>l
Forest
A tranquil forest separating your home from the city. You can see many fruit trees. A wooden bridge leads to the Town Square in the North. The Forest Clearing is to the East, and your Home is to the South.

You can see a fruit trees here.

>n
Town Square
A large square, near the entrance to the stadium. It is filled with local wizards and fans. Various posters surround the stadium's glass doors. The Forest is to the South, the Mage District is to the East, and the Memorial is to the West.

You can see a glass door, a torch and an Official here.

>talk to official
Hello, welcome to the Inferna wizard competition. Talk to the large man in the Bazaar for more information.

>w
Memorial
This area was built in dedication to the town's founder Dee Ignus. There are several murals describing Dee Ignus's many accomplishments. There is a big mural and a colorful mural. The Town Square is in the East and the Bazaar is to the West.

* * *

>x mural
Which do you mean, the big mural or the colorful mural?

>big
The picture shows a tall man controling the wind. The caption says  Dee Ignus was a powerful man. By simply saying ventus he could control the winds.

>x colorful mural
A picture shows a man confronting a large army. The caption says  Dee Ignus was a clever wizard. He used colorful spells to distract his enemies.

* * *

>talk to large man
Welcome wizard, your goal is to take the box from behind me.

>take silly box
You reach your hand out, but the man swats it away.

>distract man
That's not a verb I recognise.

* * *

>n
Forest
A tranquil forest separating your home from the city. You can see many fruit trees. A wooden bridge leads to the Town Square in the North. The Forest Clearing is to the East, and your Home is to the South.

You can see a fruit trees (in which is an apple) here.

>take apple
Taken.

* * *

>talk to hermit
Thank you. I was once a wizard you know. I would be happy to answer any of your questions.

>ask hermit about magic
The most powerful type of magic is words. Each word has its own special meaning. By stringing together different word you can create different effects.

>ask hermit about bridge
Hmm, the bridge is broken. Try using the spell pontem reficere.

* * *

>x big mural
The picture shows a tall man controling the wind. The caption says  Dee Ignus was a powerful man. By simply saying ventus he could control the winds.

>x colorful mural
A picture shows a man confronting a large army. The caption says  Dee Ignus was a clever wizard. He often used colorful spells to distract his enemies.

* * *

>take silly box
You reach your hand out, but the man swats it away.

>ignus illuminas
Bright red fireworks fill the sky. Distracted, everyone looks up at the colorful lights.
Cool a new spell. You added it to your spell book.

>take box
You quickly take the box while the man is distracted.

>x box
 A square box covered with silly pictures of mythical creatures.

>open box
You open the silly box, revealing a paper.

* * *

>magnus
Your body feels weird. Strangely stronger.

>e
Memorial
This area was built in dedication to the town's founder Dee Ignus. There are several murals describing Dee Ignus's many accomplishments. There is a big mural and a colorful mural. The Town Square is in the East and the Bazaar is to the West.

* * *

>take box
(the festive box)
It is too high up for you to reach.

>magnus ventus
A heavy wind flows through the area. The box falls into your hands.

>i
You are carrying:
  a festive box (closed)
  a paper
  a silly box (open but empty)
  a spell book
    Magnus ventus
    Ignus Illuminas
    Pontem reficere

>x festival box
You can't see any such thing.

>x festive box
A small box with the wizard festival logo on the cover. There appears to be something inside.

>open
What do you want to open?

>festive box
You open the festive box, revealing a glass key.

>w
Town Square
A large square, near the entrance to the stadium. Informational posters surround the stadium's glass doors. The Forest is to the South, the Mage District is to the East, and the Memorial is to the West.

You can see a glass door and an Official here.

* * *

>talk to official
Brilliant work! Now you have the key to the glass door. But the keyhole appears to be frozen shut.

>n
(first opening the glass door)
It seems to be locked.

>i
You are carrying:
  a festive box (open)
    a glass key
  a paper
  a silly box (open but empty)
  a spell book
    Magnus ventus
    Ignus Illuminas
    Pontem reficere

>take glass key
Taken.

>unlock glass door with key
You can't unlock this. The keyhole is frozen shut.

>magnus ignus
A powerful wave of heat flows through the area. The keyhole melts open.
Yes! A new spell

>e
Mage District
The city's oldest district and the heart of its magic. Ancient buildings extend in all directions. In the center of the road is a giant statue of the town's founder. The Town Square is to the West.

You can see Statue here.

>magnus ignus
A powerful wave of heat flows through the area.
Yes! A new spell

>magnus ignus
A powerful wave of heat flows through the area.
Yes! A new spell

* * *

>i
You are carrying:
  a glass key
  a festive box (open but empty)
  a paper
  a silly box (open but empty)
  a spell book
    Magnus Ignus
    Magnus ventus
    Ignus Illuminas
    Pontem reficere

>magnus ignus
A powerful wave of heat flows through the area.
Yes! A new spell

* * *

>take spell book
Taken.

>pontem reficere
There is no target for this spell here.

>n
Forest
A tranquil forest filled with trees and shrubs. Various rocks and bushes line the dirt road. A wooden bridge leads to the Town Square in the North. The Forest Clearing is to the East, and your Home is to the South.

>pontem reficere
You see a bright flash. When you're eyes return to normal you see a brand new bridge.

>undo
Forest
[Previous turn undone.]

>e
Forest Clearing
An opening reveals a large stream running parallel to the woods.  A Hermit is sitting on a stone bench next to the stream. The Forest is to the East.

You can see a bench (on which is a Hermit) here.

>pontem reficere
There is no target for this spell here.

* * *

>combine branch with windstone
You can't see any such thing.