It's a beautiful day in the land of Inferna. You jump out of bed excited to compete in this years annual wizard competition. The winner is declared the best wizard in the city. You may be a new wizard, but you're ready to take on the challenge.

You find yourself in your Cabin.

For hints enter "hints".

A Magical Festival
An Interactive Fiction by Cameron Haseyama
Release 1 / Serial number 131018 / Inform 7 build 6G60 (I6/v6.32 lib 6/12N) SD

Cabin
A cozy house in the woods. A wooden table is in the center of your room and your bed is in the corner. The Forest is to the North.

On the wooden table is a spell book.

>x house
A small wooden cabin. You have lived here all your life.

* * *

>take all
Not even your magic can help you take all.

>take all
(the spell book)
You already have that.

>take all
(the spell book)
You already have that.

* * *

>take all
Not even your magic can help you take all.

>take
(the avas)
Taken.

>take
(the spell book)
Taken.

>n
Forest
Tall trees separate your cabin from the city. You can see a grove of fruit trees. You see the broken bridge, which is supposed to lead to the Town Square. The Town Square is in the North. The Forest Clearing is to the East, and your Cabin is to the South.

>pontem reficere
You see a bright flash. When your eyes return to normal you see a brand new bridge.

>n
Town Square
A large square, near the entrance to the stadium. You can see the stadium's glass doors and an information board. The Forest is to the South, the Mage District is to the East, and the Memorial is to the West.

You can see a glass door and an Official here.

>magnus ignus
A powerful wave of heat flows through the area.
A beacon of light surrounds you. You sort of feel … smarter.
Magnus ignus was added to the spell book.

>e
Your current challenge doesn't require you to go here.

>w
Memorial
This area was built in dedication to the town's founder Dee Ignus. There are several murals describing Dee Ignus's many accomplishments. There is a big mural and a colorful mural. The Town Square is in the East and the Bazaar is to the West.

>w
Bazaar
The city's main marketplace. Various shops line the road, each selling different goods. There is a tent titled "Wizard Festival Challenge". Under the tent appears to be a large man guarding a box. The Town Square is to the East.

You can see a large man and a silly box here.

>ignus illuminas
Bright red fireworks fill the sky. Distracted, everyone looks up at the colorful lights.

>take box
You quickly take the box while the man is distracted.

>e
Memorial
This area was built in dedication to the town's founder Dee Ignus. There are several murals describing Dee Ignus's many accomplishments. There is a big mural and a colorful mural. The Town Square is in the East and the Bazaar is to the West.

I beg your pardon?

>e
Town Square
A large square, near the entrance to the stadium. You can see the stadium's glass doors and an information board. The Forest is to the South, the Mage District is to the East, and the Memorial is to the West.

You can see a glass door and an Official here.

>e
Mage District
The city's oldest district and the heart of its magic. Ancient buildings extend in all directions. In the center of the road is a giant statue of the town's founder. The Town Square is to the West.

You can see Statue (on which is a festive box) here.

>magnus ventus
A heavy wind flows through the area. The box falls into your hands.

 A beacon of light surrounds you. You feel sort of feel … smarter..
Magnus ventus was added to the spell book.

>open box
Which do you mean, the festive box or the silly box?

>festive
You open the festive box, revealing a glass key.

>take key
Taken.

>e
You can't go that way.

>w
Town Square
A large square, near the entrance to the stadium. You can see the stadium's glass doors and an information board. The Forest is to the South, the Mage District is to the East, and the Memorial is to the West.

You can see a glass door and an Official here.

>unlock door with key
(the glass key)
You unlock the glass door.

>n
(first opening the glass door)

Coliseum
A large area, encompassed by thousands of stands. There are many other wizards in the room. You can see a tall podium in the center of the room. 

Congratulations wizards! You have made it to the final round of the competition. Your final challange is to be the first person to get onto the podium. Your challenge begins NOW!

You can see a glass door and an apple here.

>s
Town Square
A large square, near the entrance to the stadium. You can see the stadium's glass doors and an information board. The Forest is to the South, the Mage District is to the East, and the Memorial is to the West.

You can see a glass door and an Official here.

>n
Coliseum
A large area, encompassed by thousands of stands. There are many other wizards in the room. You can see a tall podium in the center of the room. 

You can see a glass door and an apple here.

* * *

>x book
A leather book giving off the aura of magic. This is where you store your spells.

>x table
A normal wooden table. It is covered with burn marks from all your failed attempts to perform magic.

On the wooden table is a spell book.

>sleep
You aren't feeling especially drowsy.

>take book
Taken.

>i
You are carrying:
  a spell book

>read book
A leather book giving off the aura of magic. This is where you store your spells.

>n
Forest
Tall trees separate your cabin from the city. You can see a grove of fruit trees. A wooden bridge leads to the Town Square in the North. The Forest Clearing is to the East, and your Cabin is to the South.

>x fruit trees
The apple trees are blooming in the summer sun. You find an apple.

>take apple
Taken.

>x apple
A shiny Fuji apple.

>eat apple
You're not hungry right now.

>e
Forest Clearing
An opening reveals a large stream running parallel to the woods.  A Hermit is sitting on a stone bench next to the stream. The Forest is to the West.

You can see a bench (on which is a Hermit) here.

>x hermit
An old man wearing tattered clothes. He has a long grey beard and a faded robe.

>punch hermit
Violence isn't the answer to this one.

>fly away
That's not a verb I recognise.

>talk to hermit
So hungry…

>take apple for myself and eat it
I only understood you as far as wanting to take the apple.

>give hermit apple
He gratefully accepts the apple.
You see a flash of light. The Hermit's clothes transform into elegant wizard's robes.

>x wizard
You can't see any such thing.

>x hermit
An old man wearing elegant robes. The man appears to be giving off a strong magical aura.

>talk to hermit
Thank you. I was once a wizard you know. I would be happy to answer any of your questions. 
 You could try asking the Hermit about the Hermit, magic, the city, or the forest.

>ask hermit about hermit
I was once a powerful wizard, but a donkey's kick to the head left me with very little memory of spells and magic words. 
 You could try asking the Hermit about spells or magic.

>ask hermit about magic
The most powerful type of magic is words. Each word has its own special meaning. By stringing together different word you can create different effects. 
You could try asking the Hermit about magic words.

>ask hermit about magic words
Magic words are the essence of things. It is essential for wizards to use a combination of different words in order to accomplish your task. 
 You could try asking the Hermit about spells.

>ask hermit about spells
Spells are one of the most important parts of a wizard's arsenal. A wizard must know when to use each of their spells. 
 You could try asking the Hermit about the bridge.

>ask hermit about bridge
Hmm, the bridge is broken. Try using the spell pontem reficere.
Suddenly, a beacon of light surrounds you. You sort of feel … smarter.

>pontem reficere
There is no target for this spell here.

>ask hermit about city
This city is the capital of Inferna. This was the first city to be built by the powerful wizard Dee Inferna. 
 You could try asking the Hermit about Dee Inferna.

>ask hermit about dee inferna
Dee Inferna was one of the world's most powerful wizards. He saved the world from a countless number of evil threats. Today's wizard ceremony is dedicated to his memory. 
 You could try asking the Hermit about the Wizard Ceremony.

>w
Forest
Tall trees separate your cabin from the city. You can see a grove of fruit trees. A wooden bridge leads to the Town Square in the North. The Forest Clearing is to the East, and your Cabin is to the South.

>n
The bridge appears to be broken. It is too dangerous to proceed with the bridge broken.

>pontem reficere
You see a bright flash. When your eyes return to normal you see a brand new bridge.

* * *

>n
Town Square
A large square, near the entrance to the stadium. You can see the stadium's glass doors and an information board. The Forest is to the South, the Mage District is to the East, and the Memorial is to the West.

You can see a glass door and an Official here.

>read information board
A giant board advertising the Wizard Competition. One event says "Fireworks at 8:00pm. Fireworks-Ignus Illuminas  is written on the bottom.

Fireworks -  Ignus Illuminas.
Suddenly a beacon of light surrounds you. You sort of feel … smarter.tom.
Ignus Illuminas was added to the spell book.

>read book
A leather book giving off the aura of magic. This is where you store your spells.

In the spell book are Ignus Illuminas and Pontem reficere.

>i
You are carrying:
  a spell book
    Ignus Illuminas
    Pontem reficere

>x official
A young man dressed in a colorful robe. He looks like he is in charge of the competition.

>talk to official
Hello, welcome to the Inferna wizard competition. Be sure to checkout the memorial and information board before you begin your challenge. After, your first challenge is in the Bazaar. It is located to the west of the Memorial. When you're there talk to the Large Man for more information.

>l
Town Square
A large square, near the entrance to the stadium. You can see the stadium's glass doors and an information board. The Forest is to the South, the Mage District is to the East, and the Memorial is to the West.

You can see a glass door and an Official here.

>w
Memorial
This area was built in dedication to the town's founder Dee Ignus. There are several murals describing Dee Ignus's many accomplishments. There is a big mural and a colorful mural. The Town Square is in the East and the Bazaar is to the West.

>x big mural
The picture shows a tall man controlling the wind. The caption says  Dee Ignus was a powerful man. By simply saying ventus he could control the winds.

>ventus
A light breeze passes through the area.

>i
You are carrying:
  a spell book
    Ignus Illuminas
    Pontem reficere

>w
Bazaar
The city's main marketplace. Various shops line the road, each selling different goods. There is a tent titled "Wizard Festival Challenge". Under the tent appears to be a large man guarding a box. The Town Square is to the East.

You can see a large man and a silly box here.

>e
Memorial
This area was built in dedication to the town's founder Dee Ignus. There are several murals describing Dee Ignus's many accomplishments. There is a big mural and a colorful mural. The Town Square is in the East and the Bazaar is to the West.

>x colorful mural
A picture shows a man confronting a large army. The caption says  Dee Ignus was a clever wizard. He often used colorful spells to distract his enemies.

I beg your pardon?

>w
Bazaar
The city's main marketplace. Various shops line the road, each selling different goods. There is a tent titled "Wizard Festival Challenge". Under the tent appears to be a large man guarding a box. The Town Square is to the East.

You can see a large man and a silly box here.

>take box
You reach your hand out, but the man swats it away. 
 If only you had a way to distract him.

>distract man
That's not a verb I recognise.

>talk to man
Welcome wizard, your goal is to take the box from behind me.

>i
You are carrying:
  a spell book
    Ignus Illuminas
    Pontem reficere

>ignus illuminas
Bright red fireworks fill the sky. Distracted, everyone looks up at the colorful lights.

* * *

>take box
You quickly take the box while the man is distracted.

>runa way
That's not a verb I recognise.

>e
Memorial
This area was built in dedication to the town's founder Dee Ignus. There are several murals describing Dee Ignus's many accomplishments. There is a big mural and a colorful mural. The Town Square is in the East and the Bazaar is to the West.

>e
Town Square
A large square, near the entrance to the stadium. You can see the stadium's glass doors and an information board. The Forest is to the South, the Mage District is to the East, and the Memorial is to the West.

You can see a glass door and an Official here.

>x box
 A square box covered with silly pictures of mythical creatures.

>open bo
You can't see any such thing.

>open box
You open the silly box, revealing a paper.

>take paper
Taken.

>x paper
A torn piece of paper. All it says is  Magnus.

>e
Mage District
The city's oldest district and the heart of its magic. Ancient buildings extend in all directions. In the center of the road is a giant statue of the town's founder. The Town Square is to the West.

You can see Statue (on which is a festive box) here.

>x statue
 A giant statue of the town's founder, Dee Inferna. The statue stands twenty feet tall. There appears to be a small box on top of the statue.

On Statue is a festive box.

>take box
(the festive box)
It is too high up for you to reach.

>jump
You jump on the spot, fruitlessly.

>fly
That's not a verb I recognise.

>accio box
That's not a verb I recognise.

>x festive box
A small box with the wizard festival logo on the cover. There appears to be something inside.

>magnus ventus
A heavy wind flows through the area. The box falls into your hands.

 A beacon of light surrounds you. You feel sort of feel … smarter..
Magnus ventus was added to the spell book.

>x magnus ventus
 Magnus Ventus : Heavy wind.

I beg your pardon?

>put paper in book
You put the paper into the spell book.

>take magnus ventus
Don't remove this from your spell book.

* * *

>x table
A normal wooden table. It is covered with burn marks from all your failed attempts to perform magic.

On the wooden table is a spell book.

>take book
Taken.

>x book
A leather book giving off the aura of magic. This is where you store your spells.

>read book
A leather book giving off the aura of magic. This is where you store your spells.

>x bed
A single size bed worn from generations of use. It is not the most comfortable, but it works.

>go n
Forest
Tall trees separate your cabin from the city. You can see a grove of fruit trees. A wooden bridge leads to the Town Square in the North. The Forest Clearing is to the East, and your Cabin is to the South.

>x fruit trees
The apple trees are blooming in the summer sun. You find an apple.

* * *

>take apple
Taken.

>i
You are carrying:
  an apple
  a spell book

>x apple
A shiny Fuji apple.

>go n
The bridge appears to be broken. It is too dangerous to proceed with the bridge broken.

>go e
Forest Clearing
An opening reveals a large stream running parallel to the woods.  A Hermit is sitting on a stone bench next to the stream. The Forest is to the West.

You can see a bench (on which is a Hermit) here.

>x hermit
An old man wearing tattered clothes. He has a long grey beard and a faded robe.

>talk to hermit
So hungry…

>give apple to hermit
He gratefully accepts the apple.
You see a flash of light. The Hermit's clothes transform into elegant wizard's robes.

>x hermit
An old man wearing elegant robes. The man appears to be giving off a strong magical aura.

>i
You are carrying:
  a spell book

>talk to hermit
Thank you. I was once a wizard you know. I would be happy to answer any of your questions. 
 You could try asking the Hermit about the Hermit, magic, the city, or the forest.

>magic
That's not a verb I recognise.

>ask about magic
You can't see any such thing.

>ask hermit about magic
The most powerful type of magic is words. Each word has its own special meaning. By stringing together different word you can create different effects. 
You could try asking the Hermit about magic words or spells.

>ask about magic spells
You can't see any such thing.

>ask hermit about magic spells
There is no reply.

>ask hermit about spells
Spells are one of the most important parts of a wizard's arsenal. A wizard must know when to use each of their spells. 
 You could try asking the Hermit about the bridge.

>ask hermit about the bridge
There is no reply.

>ask her about bridge
I'm not sure what "her" refers to.

>ask hermit about bridge
Hmm, the bridge is broken. Try using the spell pontem reficere.
Suddenly, a beacon of light surrounds you. You sort of feel … smarter.

>go w
Forest
Tall trees separate your cabin from the city. You can see a grove of fruit trees. A wooden bridge leads to the Town Square in the North. The Forest Clearing is to the East, and your Cabin is to the South.

>go n
The bridge appears to be broken. It is too dangerous to proceed with the bridge broken.

>potem reficere
That's not a verb I recognise.

>x spell book
A leather book giving off the aura of magic. This is where you store your spells.

In the spell book is Pontem reficere.

>say pentem refiecere
(to yourself)
There is no reply.

>say pontem reficere
You see a bright flash. When your eyes return to normal you see a brand new bridge.

>go n
Town Square
A large square, near the entrance to the stadium. You can see the stadium's glass doors and an information board. The Forest is to the South, the Mage District is to the East, and the Memorial is to the West.

You can see a glass door and an Official here.

>x official
A young man dressed in a colorful robe. He looks like he is in charge of the competition.

>talk to official
Hello, welcome to the Inferna wizard competition. Be sure to checkout the memorial before you begin your challenge. After, your first challenge is in the Bazaar. It is located to the west of the Memorial. When you're there talk to the Large Man for more information.

>x glass door
The translucent glass is the only thing seperating you from the stadium.

>open glass door
It seems to be locked.

>go w
Memorial
This area was built in dedication to the town's founder Dee Ignus. There are several murals describing Dee Ignus's many accomplishments. There is a big mural and a colorful mural. The Town Square is in the East and the Bazaar is to the West.

>go w
Bazaar
The city's main marketplace. Various shops line the road, each selling different goods. There is a tent titled "Wizard Festival Challenge". Under the tent appears to be a large man guarding a box. The Town Square is to the East.

You can see a large man and a silly box here.

>x large man
A huge man wearing the Wizard Festival uniform.

>talk to large man
Welcome wizard, your goal is to take the box from behind me.

>take box
You reach your hand out, but the man swats it away.

>attack large man
Violence isn't the answer to this one.

>go e
Memorial
This area was built in dedication to the town's founder Dee Ignus. There are several murals describing Dee Ignus's many accomplishments. There is a big mural and a colorful mural. The Town Square is in the East and the Bazaar is to the West.

>go e
Town Square
A large square, near the entrance to the stadium. You can see the stadium's glass doors and an information board. The Forest is to the South, the Mage District is to the East, and the Memorial is to the West.

You can see a glass door and an Official here.

>go e
Mage District
The city's oldest district and the heart of its magic. Ancient buildings extend in all directions. In the center of the road is a giant statue of the town's founder. The Town Square is to the West.

You can see Statue (on which is a festive box) here.

>x statue
 A giant statue of the town's founder, Dee Inferna. The statue stands twenty feet tall. There appears to be a small box on top of the statue.

On Statue is a festive box.

>take box
It is too high up for you to reach.

>climb statue
I don't think much is to be achieved by that.

>go up
You can't go that way.

>go w
Town Square
A large square, near the entrance to the stadium. You can see the stadium's glass doors and an information board. The Forest is to the South, the Mage District is to the East, and the Memorial is to the West.

You can see a glass door and an Official here.

>x board
A giant board advertising the Wizard Competition. One event says "Fireworks at 8:00pm. Fireworks-Ignus Illuminas  is written on the bottom.

Fireworks -  Ignus Illuminas.
Suddenly a beacon of light surrounds you. You sort of feel … smarter.tom.
Ignus Illuminas was added to the spell book.

>go w
Memorial
This area was built in dedication to the town's founder Dee Ignus. There are several murals describing Dee Ignus's many accomplishments. There is a big mural and a colorful mural. The Town Square is in the East and the Bazaar is to the West.

>w
Bazaar
The city's main marketplace. Various shops line the road, each selling different goods. There is a tent titled "Wizard Festival Challenge". Under the tent appears to be a large man guarding a box. The Town Square is to the East.

You can see a large man and a silly box here.

>i
You are carrying:
  a spell book
    Ignus Illuminas
    Pontem reficere

>say pontem reficere
There is no target for this spell here.

>e
Memorial
This area was built in dedication to the town's founder Dee Ignus. There are several murals describing Dee Ignus's many accomplishments. There is a big mural and a colorful mural. The Town Square is in the East and the Bazaar is to the West.

* * *

>e
Mage District
The city's oldest district and the heart of its magic. Ancient buildings extend in all directions. In the center of the road is a giant statue of the town's founder. The Town Square is to the West.

You can see Statue (on which is a festive box) here.

>i
You are carrying:
  a spell book
    Ignus Illuminas
    Pontem reficere

* * *

>say pontem reficere
There is no target for this spell here.

>i
You are carrying:
  a spell book
    Ignus Illuminas
    Pontem reficere

* * *

>hints
Some players may find the temptation to rely on hints overwhelming, and you may prefer to remove temptation by disabling hints for the rest of this game. If you do so, however, you will not be able to access the hints unless you restart. Do you wish to disable hints? >

>no
Okay - but if you change your mind later you can use the HINTS OFF command to disable hints.

 > How do I fix the bridge?

>n
 > How do I fix the bridge?
 > How do I fix the bridge?

1/4: Maybe a spell could fix the bridge

Press SPACE to return to the menu or H to reveal another hint.

* * *

 > How do I fix the bridge?
 > How do I fix the bridge?

>n
 > How do I fix the bridge?
 > How do I fix the bridge?

>n
 > How do I fix the bridge?
 > How do I fix the bridge?

>j
 > How do I fix the bridge?

>h
 > How do I fix the bridge?

>h
 > How do I fix the bridge?

1/4: Maybe a spell could fix the bridge

Press SPACE to return to the menu or H to reveal another hint.

>h
1/4: Maybe a spell could fix the bridge

2/4: Maybe someone could give you the spell.

Press SPACE to return to the menu or H to reveal another hint.

>h
1/4: Maybe a spell could fix the bridge

2/4: Maybe someone could give you the spell.

3/4: If the Hermit is hungry try find some food to give him.

Press SPACE to return to the menu or H to reveal another hint.

>h
1/4: Maybe a spell could fix the bridge

2/4: Maybe someone could give you the spell.

3/4: If the Hermit is hungry try find some food to give him.

4/4: Did you try asking the Hermit about the bridge?

Press SPACE to return to the menu.

* * *

>no
Okay - but if you change your mind later you can use the HINTS OFF command to disable hints.

 > How do I fix the bridge?

>q
Cabin
A cozy house in the woods. A wooden table is in the center of your room and your bed is in the corner. The Forest is to the North.

On the wooden table is a spell book.

I beg your pardon?

>hints
 > How do I fix the bridge?

1/4: You are a wizard, maybe a spell could fix the bridge.

Press SPACE to return to the menu or H to reveal another hint.

 > How do I fix the bridge?
 > How do I fix the bridge?

1/4: You are a wizard, maybe a spell could fix the bridge.

Press SPACE to return to the menu or H to reveal another hint.

* * *

 > How do I fix the bridge?
 > How do I fix the bridge?

>1
 > How do I fix the bridge?

>q
Cabin
A cozy house in the woods. A wooden table is in the center of your room and your bed is in the corner. The Forest is to the North.

On the wooden table is a spell book.

>take spell book
Taken.

>n
Forest
Tall trees separate your cabin from the city. You can see a grove of fruit trees. A wooden bridge leads to the Town Square in the North. The Forest Clearing is to the East, and your Cabin is to the South.

>pontem reficere
You see a bright flash. When your eyes return to normal you see a brand new bridge.

* * *

>magnus ignus
A powerful wave of heat flows through the area.
A beacon of light surrounds you. You sort of feel … smarter.
Magnus ignus was added to the spell book.

>w
Memorial
This area was built in dedication to the town's founder Dee Ignus. There are several murals describing Dee Ignus's many accomplishments. There is a big mural and a colorful mural. The Town Square is in the East and the Bazaar is to the West.

>e
Town Square
A large square, near the entrance to the stadium. You can see the stadium's glass doors and an information board. The Forest is to the South, the Mage District is to the East, and the Memorial is to the West.

You can see a glass door and an Official here.

* * *

>i
You are carrying:
  a festive box (closed)
  a spell book
    Magnus Ventus
    Magnus Ignus

>open box
You open the festive box, revealing a glass key.

>take key
Taken.

* * *

>w
Town Square
A large square, near the entrance to the stadium. You can see the stadium's glass doors and an information board. The Forest is to the South, the Mage District is to the East, and the Memorial is to the West.

You can see a glass door and an Official here.

>unlock door
What do you want to unlock the glass door with?

>key
(the glass key)
You unlock the glass door.

>n
(first opening the glass door)

Coliseum
A large area, encompassed by thousands of stands. There are many other wizards in the room. You can see a tall podium in the center of the room. 

Congratulations wizards! You have made it to the final round of the competition. Your final challange is to be the first person to get onto the podium. Your challenge begins NOW!

You can see a glass door and an apple here.

>i
You are carrying:
  a glass key
  a festive box (open but empty)
  a spell book
    Magnus Ventus
    Magnus Ignus

>magnus ventus
A heavy wind flows through the area.

>magnus illuminas
A blinding light fills the room.
A beacon of light surrounds you. You sort of feel … smarter.

>ventus ignus
I only understood you as far as wanting to ventus.

>ignus ventus
Warm air circles around your feet. You rise many feet in the air.
A beacon of light surrounds you. You sort of feel … smarter. You add the spell to your spell book.

>ignus illuminas
Bright red fireworks fill the sky. Distracted, everyone looks up at the colorful lights.

You return to the ground.

>ignus ventus
Warm air circles around your feet. You rise many feet in the air.

>ventus illuminas
A light wind swirls around your feet. You feel lighter.
A beacon of light surrounds you. You sort of feel … smarter. You add the spell to your spell book.

You return to the ground.

>get on statue
You can't see any such thing.

>get on podium
You try to climb onto the podium, but a blast of water knocks you down.

>ignus illuminas
Bright red fireworks fill the sky. Distracted, everyone looks up at the colorful lights.

>get on podium
You can't reach it yet, if only you were lighter.

>hint
 > How do I get on the podium?
   How do I get the silly box?

1/11: Try combining magic words to make all possible spells.

Press SPACE to return to the menu or H to reveal another hint.

 > How do I get on the podium?
   How do I get the silly box?
 > How do I get on the podium?
   How do I get the silly box?

1/11: Try combining magic words to make all possible spells.

Press SPACE to return to the menu or H to reveal another hint.

>h
1/11: Try combining magic words to make all possible spells.

2/11: If only you could distract the competition.

Press SPACE to return to the menu or H to reveal another hint.

>h
1/11: Try combining magic words to make all possible spells.

2/11: If only you could distract the competition.

3/11: If the fireworks don't distract them maybe a bright light would.

Press SPACE to return to the menu or H to reveal another hint.

>h
1/11: Try combining magic words to make all possible spells.

2/11: If only you could distract the competition.

3/11: If the fireworks don't distract them maybe a bright light would.

4/11: Try using magnus illuminas.

Press SPACE to return to the menu or H to reveal another hint.

>h
1/11: Try combining magic words to make all possible spells.

2/11: If only you could distract the competition.

3/11: If the fireworks don't distract them maybe a bright light would.

4/11: Try using magnus illuminas.

5/11: The podium is too tall. Maybe if you were lighter you would have an easier time climbing up.

Press SPACE to return to the menu or H to reveal another hint.

>h
1/11: Try combining magic words to make all possible spells.

2/11: If only you could distract the competition.

3/11: If the fireworks don't distract them maybe a bright light would.

4/11: Try using magnus illuminas.

5/11: The podium is too tall. Maybe if you were lighter you would have an easier time climbing up.

6/11: A boost of light air could help you up.

Press SPACE to return to the menu or H to reveal another hint.

>h
1/11: Try combining magic words to make all possible spells.

2/11: If only you could distract the competition.

3/11: If the fireworks don't distract them maybe a bright light would.

4/11: Try using magnus illuminas.

5/11: The podium is too tall. Maybe if you were lighter you would have an easier time climbing up.

6/11: A boost of light air could help you up.

7/11: Try using ventus illuminas.

Press SPACE to return to the menu or H to reveal another hint.

>h
1/11: Try combining magic words to make all possible spells.

2/11: If only you could distract the competition.

3/11: If the fireworks don't distract them maybe a bright light would.

4/11: Try using magnus illuminas.

5/11: The podium is too tall. Maybe if you were lighter you would have an easier time climbing up.

6/11: A boost of light air could help you up.

7/11: Try using ventus illuminas.

8/11: Now that you're lighter, if only you could fly up to the podium.

Press SPACE to return to the menu or H to reveal another hint.

>h
1/11: Try combining magic words to make all possible spells.

2/11: If only you could distract the competition.

3/11: If the fireworks don't distract them maybe a bright light would.

4/11: Try using magnus illuminas.

5/11: The podium is too tall. Maybe if you were lighter you would have an easier time climbing up.

6/11: A boost of light air could help you up.

7/11: Try using ventus illuminas.

8/11: Now that you're lighter, if only you could fly up to the podium.

9/11: Warm air rises, right?

Press SPACE to return to the menu or H to reveal another hint.

>h
1/11: Try combining magic words to make all possible spells.

2/11: If only you could distract the competition.

3/11: If the fireworks don't distract them maybe a bright light would.

4/11: Try using magnus illuminas.

5/11: The podium is too tall. Maybe if you were lighter you would have an easier time climbing up.

6/11: A boost of light air could help you up.

7/11: Try using ventus illuminas.

8/11: Now that you're lighter, if only you could fly up to the podium.

9/11: Warm air rises, right?

10/11: Try using ignus ventus.

Press SPACE to return to the menu or H to reveal another hint.

>h
1/11: Try combining magic words to make all possible spells.

2/11: If only you could distract the competition.

3/11: If the fireworks don't distract them maybe a bright light would.

4/11: Try using magnus illuminas.

5/11: The podium is too tall. Maybe if you were lighter you would have an easier time climbing up.

6/11: A boost of light air could help you up.

7/11: Try using ventus illuminas.

8/11: Now that you're lighter, if only you could fly up to the podium.

9/11: Warm air rises, right?

10/11: Try using ignus ventus.

11/11: Try distracting the competition, becoming lighter, then flying.

Press SPACE to return to the menu.

>h
1/11: Try combining magic words to make all possible spells.

2/11: If only you could distract the competition.

3/11: If the fireworks don't distract them maybe a bright light would.

4/11: Try using magnus illuminas.

5/11: The podium is too tall. Maybe if you were lighter you would have an easier time climbing up.

6/11: A boost of light air could help you up.

7/11: Try using ventus illuminas.

8/11: Now that you're lighter, if only you could fly up to the podium.

9/11: Warm air rises, right?

10/11: Try using ignus ventus.

11/11: Try distracting the competition, becoming lighter, then flying.

Press SPACE to return to the menu.

* * *

>n
Wait, you can't forget your spell book.

>take spell book
Taken.

>n
Forest
Tall trees separate your cabin from the city. You can see a grove of fruit trees. You see the broken bridge, which is supposed to lead to the Town Square. The Town Square is in the North. The Forest Clearing is to the East, and your Cabin is to the South.

* * *

>n
Town Square
A large square, near the entrance to the stadium. You can see the stadium's glass doors and an information board. The Forest is to the South, the Mage District is to the East, and the Memorial is to the West.

You can see a glass door and an Official here.

>distract
That's not a verb I recognise.

>s
Forest
Tall trees separate your cabin from the city. You can see a grove of fruit trees. The bridge leads to the Town Square in the North. The Forest Clearing is to the East, and your Cabin is to the South.

>x trees
The apple trees are blooming in the summer sun. You find an apple.

>take apple
Taken.

>e
Forest Clearing
An opening reveals a large stream running parallel to the woods.  A Hermit is sitting on a stone bench next to the stream. The Forest is to the West.

You can see a bench (on which is a Hermit) here.

>talk to hermit
So hungry…

* * *

>give apple to hermit
He gratefully accepts the apple.
You see a flash of light. The Hermit's clothes transform into elegant wizard's robes.

>talk to hermit
Thank you. I was once a wizard you know. I would be happy to answer any of your questions. 
 You could try asking the Hermit about the Hermit, magic, the city, or the forest.

>ask hermit about magic
The most powerful type of magic is words. Each word has its own special meaning. By stringing together different word you can create different effects. 
You could try asking the Hermit about magic words.

>ask hermita about magic words
You can't see any such thing.

>ask hermit about magic words
Magic words are the essence of things. It is essential for wizards to use a combination of different words in order to accomplish your task. 
 You could try asking the Hermit about spells.

* * *

>ask hermit about bridge
Hmm, the bridge is broken. Try using the spell pontem reficere.
Suddenly, a beacon of light surrounds you. You sort of feel … smarter.

>w
Forest
Tall trees separate your cabin from the city. You can see a grove of fruit trees. The bridge leads to the Town Square in the North. The Forest Clearing is to the East, and your Cabin is to the South.

>n
Town Square
A large square, near the entrance to the stadium. You can see the stadium's glass doors and an information board. The Forest is to the South, the Mage District is to the East, and the Memorial is to the West.

You can see a glass door and an Official here.

>e
Your current challenge doesn't require you to go here.

>e
Your current challenge doesn't require you to go here.

* * *

>w
Bazaar
The city's main marketplace. Various shops line the road, each selling different goods. There is a tent titled "Wizard Festival Challenge". Under the tent appears to be a large man guarding a box. The Town Square is to the East.

You can see a large man and a silly box here.

>w
You can't go that way.

>ignus illuminas
Bright red fireworks fill the sky. Distracted, everyone looks up at the colorful lights.

* * *

>e
Town Square
A large square, near the entrance to the stadium. You can see the stadium's glass doors and an information board. The Forest is to the South, the Mage District is to the East, and the Memorial is to the West.

You can see a glass door and an Official here.

>talk to official
Nice job! Your next challenge is to get the box in the Mage District. Let me give you a quick hint. Try mixing magic words to make new spells. Remember spells are composed of two words.

* * *

>take spell book
Taken.

* * *

>n
Forest
Tall trees separate your cabin from the city. You can see a grove of fruit trees. You see the broken bridge, which is supposed to lead to the Town Square. The Town Square is in the North. The Forest Clearing is to the East, and your Cabin is to the South.

>s
Cabin
A cozy house in the woods. A wooden table is in the center of your room and your bed is in the corner. The Forest is to the North.

>n
Forest
Tall trees separate your cabin from the city. You can see a grove of fruit trees. A wooden bridge leads to the Town Square in the North. The Forest Clearing is to the East, and your Cabin is to the South.

* * *

>n
Forest
Tall trees separate your cabin from the city. You can see a grove of fruit trees. You see the broken bridge, which is supposed to lead to the Town Square. The Town Square is in the North. The Forest Clearing is to the East, and your Cabin is to the South.

>e
Forest Clearing
An opening reveals a large stream running parallel to the woods.  A Hermit is sitting on a stone bench next to the stream. The Forest is to the West.

You can see a bench (on which is a Hermit) here.

>w
Forest
Tall trees separate your cabin from the city. You can see a grove of fruit trees. You see the broken bridge, which is supposed to lead to the Town Square. The Town Square is in the North. The Forest Clearing is to the East, and your Cabin is to the South.

>pontem reficere
You see a bright flash. When your eyes return to normal you see a brand new bridge.

* * *

>n
Town Square
A large square, near the entrance to the stadium. You can see the stadium's glass doors and an information board. The Forest is to the South, the Mage District is to the East, and the Memorial is to the West.

You can see a glass door and an Official here.

>s
Forest
Tall trees separate your cabin from the city. You can see a grove of fruit trees. The bridge leads to the Town Square in the North. The Forest Clearing is to the East, and your Cabin is to the South.

>n
Town Square
A large square, near the entrance to the stadium. You can see the stadium's glass doors and an information board. The Forest is to the South, the Mage District is to the East, and the Memorial is to the West.

You can see a glass door and an Official here.

>w
Memorial
This area was built in dedication to the town's founder Dee Ignus. There are several murals describing Dee Ignus's many accomplishments. There is a big mural and a colorful mural. The Town Square is in the East and the Bazaar is to the West.

* * *

>w
Bazaar
The city's main marketplace. Various shops line the road, each selling different goods. There is a tent titled "Wizard Festival Challenge". Under the tent appears to be a large man guarding a box. The Town Square is to the East.

You can see a large man and a silly box here.

>x shops
Shops selling anything and everything wizard related. If you're looking for something special these shops would have it.

>x marketplace
The town's shopping center. Here you can find almost anything wizard related.

>ignus illuminas
Bright red fireworks fill the sky. Distracted, everyone looks up at the colorful lights.

* * *

>e
Mage District
The city's oldest district and the heart of its magic. Ancient buildings extend in all directions. In the center of the road is a giant statue of the town's founder. The Town Square is to the West.

You can see Statue (on which is a festive box) here.

>x buildings
Ancient stone buildings extend as far as the eye can see. The architecture is strange, you can tell these buildings were made by wizards.

* * *

>e
Town Square
A large square, near the entrance to the stadium. You can see the stadium's glass doors and an information board. The Forest is to the South, the Mage District is to the East, and the Memorial is to the West.

You can see a glass door and an Official here.

I beg your pardon?

>e
Mage District
The city's oldest district and the heart of its magic. Ancient buildings extend in all directions. In the center of the road is a giant statue of the town's founder. The Town Square is to the West.

You can see Statue (on which is a festive box) here.

>climb statue
You make it about two feet off the ground before falling down.

* * *

>e
Your current challenge doesn't require you to go here.

>talk to official
Hello, welcome to the Inferna wizard competition. Be sure to checkout the memorial before you begin your challenge. After, your first challenge is in the Bazaar. It is located to the west of the Memorial. When you're there talk to the Large Man for more information.

>x information board
A giant board advertising the Wizard Competition. One event says "Fireworks at 8:00pm. Fireworks-Ignus Illuminas  is written on the bottom.

Fireworks -  Ignus Illuminas.
Suddenly a beacon of light surrounds you. You sort of feel … smarter.tom.
Ignus Illuminas was added to the spell book.

>e
Your current challenge doesn't require you to go here.

* * *

>w
Memorial
This area was built in dedication to the town's founder Dee Ignus. There are several murals describing Dee Ignus's many accomplishments. There is a big mural and a colorful mural. The Town Square is in the East and the Bazaar is to the West.

>x colorful mural
A picture shows a man confronting a large army. The caption says  Dee Ignus was a clever wizard. He often used colorful spells to distract his enemies.

>e
Town Square
A large square, near the entrance to the stadium. You can see the stadium's glass doors and an information board. The Forest is to the South, the Mage District is to the East, and the Memorial is to the West.

You can see a glass door and an Official here.

>w
Memorial
This area was built in dedication to the town's founder Dee Ignus. There are several murals describing Dee Ignus's many accomplishments. There is a big mural and a colorful mural. The Town Square is in the East and the Bazaar is to the West.

* * *

>w
Bazaar
The city's main marketplace. Various shops line the road, each selling different goods. There is a tent titled "Wizard Festival Challenge". Under the tent appears to be a large man guarding a box. The Town Square is to the East.

You can see a large man and a silly box here.

>take silly box
You reach your hand out, but the man swats it away. 
 Maybe you should distract him first.

* * *

>pontem reficere
You see a bright flash. When your eyes return to normal you see a brand new bridge.

>l
Forest
Tall trees separate your cabin from the city. You can see a grove of fruit trees. The bridge leads to the Town Square in the North. The Forest Clearing is to the East, and your Cabin is to the South.

* * *

>take spell book
Taken.

>hints
Some players may find the temptation to rely on hints overwhelming, and you may prefer to remove temptation by disabling hints for the rest of this game. If you do so, however, you will not be able to access the hints unless you restart. Do you wish to disable hints? >

* * *

>no
Okay - but if you change your mind later you can use the HINTS OFF command to disable hints.

 > How do I fix the bridge?

1/4: You are a wizard, maybe a spell could fix the bridge.

Press SPACE to return to the menu or H to reveal another hint.

>h
1/4: You are a wizard, maybe a spell could fix the bridge.

2/4: Maybe you could learn the spell from someone.

Press SPACE to return to the menu or H to reveal another hint.

>h
1/4: You are a wizard, maybe a spell could fix the bridge.

2/4: Maybe you could learn the spell from someone.

3/4: If the Hermit is hungry try find some food to give him.

Press SPACE to return to the menu or H to reveal another hint.

>h
1/4: You are a wizard, maybe a spell could fix the bridge.

2/4: Maybe you could learn the spell from someone.

3/4: If the Hermit is hungry try find some food to give him.

4/4: Did you try asking the Hermit about the bridge?

Press SPACE to return to the menu.

 > How do I fix the bridge?
 > How do I fix the bridge?

>q
Cabin
A cozy house in the woods. A wooden table is in the center of your room and your bed is in the corner. The Forest is to the North.

>i
You are carrying:
  a spell book

>n
Forest
Tall trees separate your cabin from the city. You can see a grove of fruit trees. A wooden bridge leads to the Town Square in the North. The Forest Clearing is to the East, and your Cabin is to the South.

* * *

>n
Town Square
A large square, near the entrance to the stadium. You can see the stadium's glass doors and an information board. The Forest is to the South, the Mage District is to the East, and the Memorial is to the West.

You can see a glass door and an Official here.

>i
You are carrying:
  a spell book

>hint
 > How do I get the silly box?

>h
 > How do I get the silly box?

1/5: Did you try to distract the large man?

Press SPACE to return to the menu or H to reveal another hint.

>h
1/5: Did you try to distract the large man?

2/5: Maybe a spell could help you distract him.

Press SPACE to return to the menu or H to reveal another hint.

>h
1/5: Did you try to distract the large man?

2/5: Maybe a spell could help you distract him.

3/5: Try examining things to find the right spell.

Press SPACE to return to the menu or H to reveal another hint.

>h
1/5: Did you try to distract the large man?

2/5: Maybe a spell could help you distract him.

3/5: Try examining things to find the right spell.

4/5: Are you sure you want the final hint?

Press SPACE to return to the menu or H to reveal another hint.

>h
1/5: Did you try to distract the large man?

2/5: Maybe a spell could help you distract him.

3/5: Try examining things to find the right spell.

4/5: Are you sure you want the final hint?

5/5: Did you try checking the information board?

Press SPACE to return to the menu.

 > How do I get the silly box?
 > How do I get the silly box?

>q
Town Square
A large square, near the entrance to the stadium. You can see the stadium's glass doors and an information board. The Forest is to the South, the Mage District is to the East, and the Memorial is to the West.

You can see a glass door and an Official here.

>magnus ignus
A powerful wave of heat flows through the area.
A beacon of light surrounds you. You sort of feel … smarter.
Magnus ignus was added to the spell book.

>e
Mage District
The city's oldest district and the heart of its magic. Ancient buildings extend in all directions. In the center of the road is a giant statue of the town's founder. The Town Square is to the West.

You can see Statue (on which is a festive box) here.

* * *

>magnus ventus
A heavy wind flows through the area. The box falls into your hands.

 A beacon of light surrounds you. You feel sort of feel … smarter..
Magnus ventus was added to the spell book.

>e
You can't go that way.

* * *

>w
Town Square
A large square, near the entrance to the stadium. You can see the stadium's glass doors and an information board. The Forest is to the South, the Mage District is to the East, and the Memorial is to the West.

You can see a glass door and an Official here.

>unlock door with key
(first taking the key hole)
That's hardly portable.

>unlock door with glass key
I only understood you as far as wanting to unlock the glass door with the glass door.

>n
(first opening the glass door)
It seems to be locked.

>i
You are carrying:
  a festive box (closed)
  a spell book
    Magnus Ventus
    Magnus Ignus

* * *

>open box
You open the festive box, revealing a glass key.

>take key
(the glass key)
Taken.

>unlock door with key
(the glass key)
You unlock the glass door.

>unlock door with key
(the glass key)
That's unlocked at the moment.

>n
(first opening the glass door)

Coliseum
A large area, encompassed by thousands of stands. There are many other wizards in the room. You can see a tall podium in the center of the room. 

Congratulations wizards! You have made it to the final round of the competition. Your final challange is to be the first person to get onto the podium. Your challenge begins NOW!

You can see a glass door and an apple here.

>magnus illuminas
A blinding light fills the room.
A beacon of light surrounds you. You sort of feel … smarter.

>ventus illuminas
A light wind swirls around your feet. You feel lighter.
A beacon of light surrounds you. You sort of feel … smarter. You add the spell to your spell book.

>ignus ventus
Warm air circles around your feet. You rise many feet in the air.
A beacon of light surrounds you. You sort of feel … smarter. You add the spell to your spell book.

>get on podium
You lean forward and fly onto the podium.
Congratulations, you win!

    *** You have won ***

Would you like to RESTART, RESTORE a saved game, QUIT or UNDO the last command?

>undo
Coliseum
[Previous turn undone.]

>undo
Coliseum
[Previous turn undone.]

>s
Town Square
A large square, near the entrance to the stadium. You can see the stadium's glass doors and an information board. The Forest is to the South, the Mage District is to the East, and the Memorial is to the West.

You can see a glass door and an Official here.

* * *

>n
Coliseum
A large area, encompassed by thousands of stands. There are many other wizards in the room. You can see a tall podium in the center of the room. 

You can see a glass door and an apple here.

>magnus illuminas
A blinding light fills the room.

>ventus illuminas
A light wind swirls around your feet. You feel lighter.
A beacon of light surrounds you. You sort of feel … smarter. You add the spell to your spell book.

* * *

>ignus ventus
Warm air circles around your feet. You rise many feet in the air.
A beacon of light surrounds you. You sort of feel … smarter. You add the spell to your spell book.

>get on podium
You try to climb onto the podium, but a fireball knocks you down. 
 If there was only some way to distract your competitors.

You return to the ground.

>magnus illuminas
A blinding light fills the room.

>ventus illuminas
A light wind swirls around your feet. You feel lighter.

>ignus ventus
Warm air circles around your feet. You rise many feet in the air.

>get on podium
You lean forward and fly onto the podium.
Congratulations, you win!

    *** You have won ***

Would you like to RESTART, RESTORE a saved game, QUIT or UNDO the last command?

* * *

>undo
Coliseum
[Previous turn undone.]

>drop box
You may need this later.

You return to the ground.